広域_ID,広域_名称,全国地方公共団体コード_ID,基礎_名称,人口（男女総数）,人口（男性）,人口（女性）,2015年（平成27年）の人口（組替）（人）,5年間の人口増減数（人）,5年間の人口増減率（％）,人口性比,面積（km2）,人口密度（1km2当たり）,世帯数（世帯）,2015年（平成27年）の世帯数（組替）（世帯）,5年間の世帯増減数（世帯）,5年間の世帯増減率（％）
01,北海道,01100,札幌市,1975065,918738,1056327,1952356,22709,1.16316,86.97477,1121.26,1761.5,966009,921837,44172,4.79174
01,北海道,01101,札幌市中央区,248840,112806,136034,237627,11213,4.71874,82.92486,46.42,5360.6,140898,132006,8892,6.73606
01,北海道,01102,札幌市北区,289667,136651,153016,285321,4346,1.5232,89.30504,63.57,4556.7,139019,133662,5357,4.00787
01,北海道,01103,札幌市東区,265536,125980,139556,261912,3624,1.38367,90.27201,56.97,4661,131156,124425,6731,5.40968
01,北海道,01104,札幌市白石区,212001,100071,111930,209584,2417,1.15324,89.40499,34.47,6150.3,107667,104608,3059,2.92425
01,北海道,01105,札幌市豊平区,225482,104183,121299,218652,6830,3.12369,85.88941,46.23,4877.4,118256,110171,8085,7.33859
01,北海道,01106,札幌市南区,135966,62379,73587,141190,-5224,-3.69998,84.76905,657.48,206.8,62013,61291,722,1.17799
01,北海道,01107,札幌市西区,217230,100077,117153,213578,3652,1.70991,85.42419,75.1,2892.5,103480,97750,5730,5.86189
01,北海道,01108,札幌市厚別区,125182,56741,68441,127767,-2585,-2.02321,82.90498,24.38,5134.6,57208,55585,1623,2.91985
01,北海道,01109,札幌市手稲区,142712,66918,75794,140999,1713,1.2149,88.28931,56.77,2513.9,60775,57333,3442,6.00352
01,北海道,01110,札幌市清田区,112449,52932,59517,115726,-3277,-2.83169,88.93593,59.87,1878.2,45537,45006,531,1.17984
01,北海道,01202,函館市,251271,113972,137299,265979,-14708,-5.52976,83.01007,677.87,370.7,121570,123950,-2380,-1.92013
01,北海道,01203,小樽市,111422,50148,61274,121924,-10502,-8.61356,81.84222,243.83,457,52704,55466,-2762,-4.97963
01,北海道,01204,旭川市,329513,152162,177351,339605,-10092,-2.97169,85.79709,747.66,440.7,156185,155747,438,0.28123
01,北海道,01205,室蘭市,82457,40403,42054,88564,-6107,-6.89558,96.0741,81.01,1017.9,41496,43616,-2120,-4.8606
01,北海道,01206,釧路市,165230,77512,87718,174742,-9512,-5.44345,88.36499,1363.29,121.2,80161,82078,-1917,-2.33558
01,北海道,01207,帯広市,166690,79642,87048,169327,-2637,-1.55734,91.49205,619.34,269.1,80104,77707,2397,3.08466
01,北海道,01208,北見市,115608,54742,60866,121226,-5618,-4.63432,89.93855,1427.41,81,55070,56202,-1132,-2.01416
01,北海道,01209,夕張市,7341,3385,3956,8843,-1502,-16.98519,85.56623,763.07,9.6,3814,4539,-725,-15.97268
01,北海道,01210,岩見沢市,79424,37138,42286,84499,-5075,-6.00599,87.82576,481.02,165.1,35381,36155,-774,-2.14078
01,北海道,01211,網走市,35783,18065,17718,39077,-3294,-8.42951,101.95846,471,76,17241,18035,-794,-4.40255
01,北海道,01212,留萌市,20123,9653,10470,22221,-2098,-9.44152,92.19675,297.84,67.6,9795,10402,-607,-5.83542
01,北海道,01213,苫小牧市,170234,83561,86673,172737,-2503,-1.44902,96.40949,561.57,303.1,79994,78298,1696,2.16608
01,北海道,01214,稚内市,33584,16645,16939,36380,-2796,-7.68554,98.26436,761.47,44.1,16053,16486,-433,-2.62647
01,北海道,01215,美唄市,20430,9568,10862,23035,-2605,-11.30888,88.08691,277.69,73.6,9401,10173,-772,-7.58872
01,北海道,01216,芦別市,12578,5768,6810,14676,-2098,-14.29545,84.69897,865.04,14.5,6048,6862,-814,-11.86243
01,北海道,01217,江別市,121145,57544,63601,120636,509,0.42193,90.47656,187.38,646.5,53925,51983,1942,3.73584
01,北海道,01218,赤平市,9707,4389,5318,11105,-1398,-12.58892,82.53103,129.88,74.7,4491,4980,-489,-9.81928
01,北海道,01219,紋別市,21224,9905,11319,23109,-1885,-8.157,87.50773,830.67,25.6,11213,11127,86,0.77289
01,北海道,01220,士別市,17872,8421,9451,19914,-2042,-10.25409,89.10168,1119.22,16,8180,8650,-470,-5.43353
01,北海道,01221,名寄市,27289,13321,13968,29048,-1759,-6.05549,95.36798,535.2,51,12789,13086,-297,-2.2696
01,北海道,01222,三笠市,8038,3630,4408,9076,-1038,-11.43676,82.35027,302.52,26.6,3825,4254,-429,-10.08463
01,北海道,01223,根室市,24669,11765,12904,26917,-2248,-8.3516,91.17328,506.25,60,11156,11383,-227,-1.9942
01,北海道,01224,千歳市,98019,49794,48225,95648,2371,2.47888,103.2535,594.5,164.9,43712,40638,3074,7.56435
01,北海道,01225,滝川市,39533,18832,20701,41192,-1659,-4.02748,90.97145,115.9,341.1,18695,18651,44,0.23591
01,北海道,01226,砂川市,16506,7610,8896,17694,-1188,-6.71414,85.54406,78.68,209.8,7593,7858,-265,-3.37236
01,北海道,01227,歌志内市,2989,1399,1590,3585,-596,-16.62483,87.98742,55.95,53.4,1423,1665,-242,-14.53453
01,北海道,01228,深川市,20062,9365,10697,21909,-1847,-8.43033,87.54791,529.42,37.9,9188,9669,-481,-4.97466
01,北海道,01229,富良野市,21156,9950,11206,22936,-1780,-7.76073,88.79172,600.71,35.2,9561,9929,-368,-3.70631
01,北海道,01230,登別市,46447,22158,24289,49625,-3178,-6.40403,91.22648,212.21,218.9,20927,21681,-754,-3.4777
01,北海道,01231,恵庭市,70378,34094,36284,69702,676,0.96984,93.96428,294.65,238.9,30133,28846,1287,4.46162
01,北海道,01233,伊達市,32857,15171,17686,34995,-2138,-6.10944,85.77971,444.21,74,14846,15054,-208,-1.38169
01,北海道,01234,北広島市,58234,27776,30458,59064,-830,-1.40526,91.19443,119.05,489.2,24621,23551,1070,4.54333
01,北海道,01235,石狩市,56934,27331,29603,57436,-502,-0.87402,92.3251,722.42,78.8,23055,22632,423,1.86903
01,北海道,01236,北斗市,44331,20548,23783,46390,-2059,-4.43846,86.39785,397.44,111.5,18110,18508,-398,-2.15042
01,北海道,01303,当別町,15921,7705,8216,17278,-1357,-7.85392,93.78043,422.86,37.7,7270,7327,-57,-0.77794
01,北海道,01304,新篠津村,3046,1484,1562,3329,-283,-8.50105,95.0064,78.04,39,1052,1070,-18,-1.68224
01,北海道,01331,松前町,6260,2803,3457,7337,-1077,-14.67902,81.08186,293.25,21.3,3196,3571,-375,-10.50126
01,北海道,01332,福島町,3794,1755,2039,4422,-628,-14.20172,86.0716,187.25,20.3,1858,2039,-181,-8.8769
01,北海道,01333,知内町,4167,2058,2109,4653,-486,-10.44487,97.58179,196.75,21.2,1866,2003,-137,-6.83974
01,北海道,01334,木古内町,3836,1753,2083,4547,-711,-15.63668,84.15747,221.87,17.3,1870,2140,-270,-12.61682
01,北海道,01337,七飯町,27707,12677,15030,28120,-413,-1.46871,84.34464,216.75,127.8,11518,11141,377,3.3839
01,北海道,01343,鹿部町,3762,1785,1977,4226,-464,-10.97965,90.28832,110.63,34,1618,1660,-42,-2.53012
01,北海道,01345,森町,14343,6662,7681,15946,-1603,-10.05268,86.7335,368.79,38.9,6331,6628,-297,-4.48099
01,北海道,01346,八雲町,15844,7905,7939,17252,-1408,-8.16137,99.57173,956.08,16.6,7492,7523,-31,-0.41207
01,北海道,01347,長万部町,5113,2448,2665,5926,-813,-13.7192,91.85741,310.76,16.5,2450,2685,-235,-8.75233
01,北海道,01361,江差町,7435,3563,3872,8248,-813,-9.85694,92.01963,109.48,67.9,3522,3752,-230,-6.13006
01,北海道,01362,上ノ国町,4308,1963,2345,4876,-568,-11.64889,83.71002,547.71,7.9,2053,2173,-120,-5.52232
01,北海道,01363,厚沢部町,3593,1719,1874,4049,-456,-11.26204,91.72892,460.58,7.8,1645,1765,-120,-6.79887
01,北海道,01364,乙部町,3406,1539,1867,3906,-500,-12.80082,82.43171,162.59,20.9,1596,1729,-133,-7.69231
01,北海道,01367,奥尻町,2412,1280,1132,2690,-278,-10.33457,113.0742,142.99,16.9,1219,1270,-51,-4.01575
01,北海道,01370,今金町,5076,2448,2628,5628,-552,-9.8081,93.15068,568.25,8.9,2172,2280,-108,-4.73684
01,北海道,01371,せたな町,7405,3466,3939,8473,-1068,-12.60474,87.99188,638.68,11.6,3534,3862,-328,-8.49301
01,北海道,01391,島牧村,1352,686,666,1499,-147,-9.80654,103.003,437.18,3.1,625,661,-36,-5.44629
01,北海道,01392,寿都町,2837,1395,1442,3137,-300,-9.56328,96.74064,95.25,29.8,1338,1420,-82,-5.77465
01,北海道,01393,黒松内町,2793,1351,1442,3082,-289,-9.37703,93.68932,345.65,8.1,1307,1336,-29,-2.17066
01,北海道,01394,蘭越町,4573,2197,2376,4843,-270,-5.57506,92.46633,449.78,10.2,2098,2086,12,0.57526
01,北海道,01395,ニセコ町,5077,2622,2455,4958,119,2.40016,106.80244,197.13,25.8,2511,2274,237,10.42216
01,北海道,01396,真狩村,2046,1036,1010,2103,-57,-2.71041,102.57426,114.25,17.9,903,855,48,5.61404
01,北海道,01397,留寿都村,1909,972,937,1907,2,0.10488,103.73533,119.84,15.9,970,915,55,6.01093
01,北海道,01398,喜茂別町,2155,1114,1041,2294,-139,-6.05929,107.01249,189.41,11.4,1129,1123,6,0.53428
01,北海道,01399,京極町,2942,1420,1522,3187,-245,-7.68748,93.29829,231.49,12.7,1259,1281,-22,-1.71741
01,北海道,01400,倶知安町,15137,7788,7349,15018,119,0.79238,105.9736,261.34,57.9,7609,6974,635,9.10525
01,北海道,01401,共和町,5775,3047,2728,6224,-449,-7.21401,111.69355,304.92,18.9,2735,2854,-119,-4.16959
01,北海道,01402,岩内町,11654,5506,6148,13042,-1388,-10.64254,89.55758,70.6,165.1,5746,6228,-482,-7.73924
01,北海道,01403,泊村,1572,785,787,1771,-199,-11.23659,99.74587,82.27,19.1,812,886,-74,-8.35214
01,北海道,01404,神恵内村,870,398,472,1004,-134,-13.34661,84.32203,147.79,5.9,400,434,-34,-7.8341
01,北海道,01405,積丹町,1831,855,976,2115,-284,-13.4279,87.60246,238.13,7.7,884,994,-110,-11.0664
01,北海道,01406,古平町,2755,1306,1449,3188,-433,-13.58218,90.13112,188.36,14.6,1248,1446,-198,-13.69295
01,北海道,01407,仁木町,3182,1524,1658,3498,-316,-9.03373,91.91797,167.96,18.9,1332,1480,-148,-10
01,北海道,01408,余市町,18012,8340,9672,19607,-1595,-8.13485,86.22829,140.59,128.1,8272,8769,-497,-5.66769
01,北海道,01409,赤井川村,1165,605,560,1121,44,3.92507,108.03571,280.09,4.2,621,534,87,16.29213
01,北海道,01423,南幌町,7328,3463,3865,7927,-599,-7.55645,89.59897,81.36,90.1,2946,2973,-27,-0.90817
01,北海道,01424,奈井江町,5122,2405,2717,5674,-552,-9.72859,88.51675,88.19,58.1,2320,2466,-146,-5.92052
01,北海道,01425,上砂川町,2847,1290,1557,3479,-632,-18.16614,82.85164,39.98,71.2,1485,1744,-259,-14.85092
01,北海道,01427,由仁町,4818,2299,2519,5314,-496,-9.33384,91.26638,133.74,36,2061,2149,-88,-4.09493
01,北海道,01428,長沼町,10300,4926,5374,11076,-776,-7.00614,91.66357,168.52,61.1,4089,4257,-168,-3.94644
01,北海道,01429,栗山町,11262,5167,6095,12344,-1082,-8.76539,84.77441,203.93,55.2,4958,5186,-228,-4.39645
01,北海道,01430,月形町,3692,2185,1507,4577,-885,-19.33581,144.99005,150.4,24.5,1324,1466,-142,-9.68622
01,北海道,01431,浦臼町,1725,837,888,1985,-260,-13.09824,94.25676,101.83,16.9,783,850,-67,-7.88235
01,北海道,01432,新十津川町,6486,2972,3514,6831,-345,-5.05051,84.57598,495.47,13.1,2537,2570,-33,-1.28405
01,北海道,01433,妹背牛町,2696,1290,1406,3091,-395,-12.77904,91.74964,48.64,55.4,1257,1269,-12,-0.94563
01,北海道,01434,秩父別町,2330,1072,1258,2513,-183,-7.28213,85.21463,47.18,49.4,982,1017,-35,-3.44149
01,北海道,01436,雨竜町,2392,1166,1226,2749,-357,-12.98654,95.10604,191.15,12.5,926,1005,-79,-7.8607
01,北海道,01437,北竜町,1711,822,889,1981,-270,-13.62948,92.46344,158.7,10.8,748,782,-34,-4.34783
01,北海道,01438,沼田町,2903,1389,1514,3181,-278,-8.73939,91.74373,283.35,10.2,1241,1333,-92,-6.90173
01,北海道,01452,鷹栖町,6572,3107,3465,7018,-446,-6.35509,89.66811,139.42,47.1,2657,2717,-60,-2.20832
01,北海道,01453,東神楽町,10141,4703,5438,10233,-92,-0.89905,86.484,68.5,148,3841,3657,184,5.03145
01,北海道,01454,当麻町,6326,2916,3410,6689,-363,-5.42682,85.5132,204.9,30.9,2776,2698,78,2.89103
01,北海道,01455,比布町,3520,1662,1858,3777,-257,-6.80434,89.45102,86.9,40.5,1569,1586,-17,-1.07188
01,北海道,01456,愛別町,2610,1218,1392,2976,-366,-12.29839,87.5,250.13,10.4,1187,1305,-118,-9.04215
01,北海道,01457,上川町,3502,1709,1793,4044,-542,-13.40257,95.31511,1049.47,3.3,1913,2102,-189,-8.99144
01,北海道,01458,東川町,8315,3878,4437,8111,204,2.5151,87.4014,247.3,33.6,3408,3148,260,8.25921
01,北海道,01459,美瑛町,9717,4508,5209,10292,-575,-5.58686,86.54252,676.78,14.4,4214,4288,-74,-1.72575
01,北海道,01460,上富良野町,10353,5358,4995,10826,-473,-4.36911,107.26727,237.1,43.7,4290,4363,-73,-1.67316
01,北海道,01461,中富良野町,4741,2263,2478,5069,-328,-6.4707,91.32365,108.65,43.6,1977,2025,-48,-2.37037
01,北海道,01462,南富良野町,2376,1228,1148,2555,-179,-7.00587,106.96864,665.54,3.6,1085,1132,-47,-4.15194
01,北海道,01463,占冠村,1307,652,655,1211,96,7.92733,99.54198,571.41,2.3,849,704,145,20.59659
01,北海道,01464,和寒町,3193,1498,1695,3596,-403,-11.2069,88.37758,225.11,14.2,1433,1533,-100,-6.52316
01,北海道,01465,剣淵町,2927,1426,1501,3228,-301,-9.32466,95.00333,130.99,22.3,1239,1330,-91,-6.84211
01,北海道,01468,下川町,3127,1494,1633,3547,-420,-11.84099,91.48806,644.2,4.9,1467,1674,-207,-12.36559
01,北海道,01469,美深町,4147,2038,2109,4659,-512,-10.98948,96.63348,672.09,6.2,1912,2041,-129,-6.32043
01,北海道,01470,音威子府村,706,365,341,832,-126,-15.14423,107.03812,275.63,2.6,346,405,-59,-14.5679
01,北海道,01471,中川町,1528,805,723,1767,-239,-13.52575,111.34163,594.74,2.6,822,897,-75,-8.3612
01,北海道,01472,幌加内町,1371,682,689,1525,-154,-10.09836,98.98403,767.04,1.8,676,690,-14,-2.02899
01,北海道,01481,増毛町,3912,1774,2138,4497,-585,-13.00867,82.97474,369.71,10.6,1809,2051,-242,-11.79912
01,北海道,01482,小平町,2998,1432,1566,3336,-338,-10.13189,91.44317,627.22,4.8,1374,1406,-32,-2.27596
01,北海道,01483,苫前町,2936,1424,1512,3265,-329,-10.07657,94.17989,454.6,6.5,1346,1420,-74,-5.21127
01,北海道,01484,羽幌町,6551,3163,3388,7327,-776,-10.59096,93.35891,472.65,13.9,3144,3367,-223,-6.62311
01,北海道,01485,初山別村,1080,518,562,1217,-137,-11.25719,92.17082,279.52,3.9,505,537,-32,-5.95903
01,北海道,01486,遠別町,2521,1224,1297,2806,-285,-10.15681,94.37163,590.8,4.3,1194,1225,-31,-2.53061
01,北海道,01487,天塩町,2950,1479,1471,3243,-293,-9.03484,100.54385,353.56,8.3,1445,1502,-57,-3.79494
01,北海道,01511,猿払村,2612,1286,1326,2684,-72,-2.68256,96.98341,589.99,4.4,1238,1174,64,5.45145
01,北海道,01512,浜頓別町,3454,1678,1776,3881,-427,-11.00232,94.48198,401.64,8.6,1719,1845,-126,-6.82927
01,北海道,01513,中頓別町,1638,818,820,1757,-119,-6.77291,99.7561,398.51,4.1,774,775,-1,-0.12903
01,北海道,01514,枝幸町,7579,3598,3981,8437,-858,-10.16949,90.3793,1115.93,6.8,3518,3772,-254,-6.73383
01,北海道,01516,豊富町,3975,2099,1876,4054,-79,-1.94869,111.88699,520.69,7.6,1946,1782,164,9.20314
01,北海道,01517,礼文町,2510,1285,1225,2773,-263,-9.48431,104.89796,81.64,30.7,1244,1353,-109,-8.05617
01,北海道,01518,利尻町,2005,993,1012,2303,-298,-12.93964,98.12253,76.5,26.2,1038,1154,-116,-10.05199
01,北海道,01519,利尻富士町,2457,1186,1271,2787,-330,-11.84069,93.31235,105.62,23.3,1199,1264,-65,-5.14241
01,北海道,01520,幌延町,2373,1292,1081,2447,-74,-3.02411,119.51896,574.1,4.1,1231,1138,93,8.17223
01,北海道,01543,美幌町,18705,9068,9637,20296,-1591,-7.83898,94.09567,438.41,42.7,8323,8626,-303,-3.51264
01,北海道,01544,津別町,4369,2095,2274,5008,-639,-12.75958,92.12841,716.8,6.1,2043,2231,-188,-8.42671
01,北海道,01545,斜里町,11443,5686,5757,12231,-788,-6.44265,98.76672,737.13,15.5,5371,5547,-176,-3.17289
01,北海道,01546,清里町,3888,1885,2003,4221,-333,-7.88913,94.10884,402.76,9.7,1589,1671,-82,-4.90724
01,北海道,01547,小清水町,4621,2208,2413,5085,-464,-9.12488,91.50435,286.89,16.1,1943,2033,-90,-4.42696
01,北海道,01549,訓子府町,4682,2241,2441,5100,-418,-8.19608,91.80664,190.95,24.5,1873,1910,-37,-1.93717
01,北海道,01550,置戸町,2776,1279,1497,3092,-316,-10.21992,85.43754,527.27,5.3,1202,1304,-102,-7.82209
01,北海道,01552,佐呂間町,4879,2299,2580,5362,-483,-9.00783,89.10853,404.94,12,2265,2311,-46,-1.99048
01,北海道,01555,遠軽町,19250,9340,9910,20873,-1623,-7.7756,94.24823,1332.45,14.4,8803,9278,-475,-5.11964
01,北海道,01559,湧別町,8275,3950,4325,9231,-956,-10.35641,91.32948,505.79,16.4,3692,3861,-169,-4.3771
01,北海道,01560,滝上町,2421,1177,1244,2721,-300,-11.02536,94.61415,766.89,3.2,1226,1295,-69,-5.32819
01,北海道,01561,興部町,3629,1764,1865,3909,-280,-7.16296,94.58445,362.54,10,1711,1757,-46,-2.6181
01,北海道,01562,西興部村,1052,520,532,1116,-64,-5.73477,97.74436,308.08,3.4,492,501,-9,-1.79641
01,北海道,01563,雄武町,4204,2006,2198,4525,-321,-7.09392,91.26479,636.89,6.6,1908,2062,-154,-7.46848
01,北海道,01564,大空町,6821,3335,3486,7360,-539,-7.32337,95.66839,343.66,19.8,2746,2874,-128,-4.45372
01,北海道,01571,豊浦町,3824,1784,2040,4291,-467,-10.88324,87.45098,233.57,16.4,1773,1973,-200,-10.13685
01,北海道,01575,壮瞥町,2749,1286,1463,2922,-173,-5.9206,87.90157,205.01,13.4,1170,1168,2,0.17123
01,北海道,01578,白老町,16225,7708,8517,17740,-1515,-8.54002,90.50135,425.64,38.1,7679,7955,-276,-3.46952
01,北海道,01581,厚真町,4439,2249,2190,4838,-399,-8.24721,102.69406,404.61,11,1932,2126,-194,-9.12512
01,北海道,01584,洞爺湖町,8453,3912,4541,9299,-846,-9.09775,86.14843,180.87,46.7,4047,4240,-193,-4.55189
01,北海道,01585,安平町,7343,3633,3710,8148,-805,-9.87973,97.92453,237.16,31,3450,3651,-201,-5.50534
01,北海道,01586,むかわ町,7650,3784,3866,8596,-946,-11.00512,97.87894,711.36,10.8,3672,3784,-112,-2.95983
01,北海道,01601,日高町,11289,5711,5578,12378,-1089,-8.79787,102.38437,992.14,11.4,5549,5781,-232,-4.01315
01,北海道,01602,平取町,4760,2384,2376,5315,-555,-10.44214,100.3367,743.09,6.4,2295,2373,-78,-3.28698
01,北海道,01604,新冠町,5315,2605,2710,5592,-277,-4.95351,96.12546,585.81,9.1,2451,2405,46,1.91268
01,北海道,01607,浦河町,12083,5971,6112,13075,-992,-7.587,97.69306,694.26,17.4,5908,6178,-270,-4.37035
01,北海道,01608,様似町,4045,1924,2121,4518,-473,-10.46923,90.71193,364.3,11.1,1915,2044,-129,-6.31115
01,北海道,01609,えりも町,4376,2232,2144,4906,-530,-10.8031,104.10448,284,15.4,1808,1929,-121,-6.27268
01,北海道,01610,新ひだか町,21522,10476,11046,23231,-1709,-7.35655,94.83976,1147.55,18.8,10198,10443,-245,-2.34607
01,北海道,01631,音更町,43613,20638,22975,44807,-1194,-2.66476,89.82807,466.02,93.6,18306,18019,287,1.59276
01,北海道,01632,士幌町,5854,2891,2963,6132,-278,-4.53359,97.57003,259.19,22.6,2522,2479,43,1.73457
01,北海道,01633,上士幌町,4770,2341,2429,4765,5,0.10493,96.37711,694.23,6.9,2495,2177,318,14.60726
01,北海道,01634,鹿追町,5270,2579,2691,5542,-272,-4.90798,95.83798,402.88,13.1,2252,2258,-6,-0.26572
01,北海道,01635,新得町,5817,2902,2915,6288,-471,-7.49046,99.55403,1063.83,5.5,2847,3043,-196,-6.44101
01,北海道,01636,清水町,9106,4481,4625,9599,-493,-5.13595,96.88649,402.25,22.6,4158,4131,27,0.65359
01,北海道,01637,芽室町,18078,8616,9462,18484,-406,-2.19649,91.05897,513.76,35.2,7238,7169,69,0.96248
01,北海道,01638,中札内村,3891,1881,2010,3966,-75,-1.89107,93.58209,292.58,13.3,1684,1609,75,4.66128
01,北海道,01639,更別村,3080,1518,1562,3185,-105,-3.2967,97.1831,176.9,17.4,1311,1239,72,5.81114
01,北海道,01641,大樹町,5424,2713,2711,5738,-314,-5.47229,100.07377,815.68,6.6,2593,2534,59,2.32833
01,北海道,01642,広尾町,6388,3097,3291,7030,-642,-9.13229,94.10514,596.54,10.7,3001,3157,-156,-4.9414
01,北海道,01643,幕別町,25778,12246,13532,26760,-982,-3.66966,90.4966,477.64,54,11013,10944,69,0.63048
01,北海道,01644,池田町,6299,2972,3327,6882,-583,-8.47137,89.32973,371.79,16.9,2966,3044,-78,-2.56242
01,北海道,01645,豊頃町,3020,1478,1542,3182,-162,-5.09114,95.84955,536.71,5.6,1354,1362,-8,-0.58737
01,北海道,01646,本別町,6624,3229,3395,7358,-734,-9.97554,95.11046,391.91,16.9,3099,3260,-161,-4.93865
01,北海道,01647,足寄町,6562,3213,3349,6990,-428,-6.12303,95.93909,1408.04,4.7,3095,3179,-84,-2.64234
01,北海道,01648,陸別町,2265,1138,1127,2482,-217,-8.74295,100.97604,608.9,3.7,1051,1128,-77,-6.82624
01,北海道,01649,浦幌町,4389,2140,2249,4919,-530,-10.77455,95.1534,729.85,6,1992,2086,-94,-4.50623
01,北海道,01661,釧路町,19115,9102,10013,19833,-718,-3.62023,90.90183,252.66,75.7,8256,8119,137,1.6874
01,北海道,01662,厚岸町,8893,4172,4721,9778,-885,-9.05093,88.37111,739.27,12,4021,4115,-94,-2.28433
01,北海道,01663,浜中町,5511,2728,2783,6061,-550,-9.07441,98.02372,423.63,13,2310,2325,-15,-0.64516
01,北海道,01664,標茶町,7230,3469,3761,7742,-512,-6.61328,92.23611,1099.37,6.6,3245,3281,-36,-1.09723
01,北海道,01665,弟子屈町,6961,3316,3645,7758,-797,-10.27327,90.97394,774.33,9,3320,3509,-189,-5.38615
01,北海道,01667,鶴居村,2564,1257,1307,2534,30,1.1839,96.17445,571.8,4.5,1119,1026,93,9.06433
01,北海道,01668,白糠町,7294,3414,3880,8068,-774,-9.59346,87.98969,773.13,9.4,3477,3609,-132,-3.65752
01,北海道,01691,別海町,14382,7287,7095,15273,-891,-5.83382,102.70613,1319.63,10.9,6091,5997,94,1.56745
01,北海道,01692,中標津町,23023,11341,11682,23774,-751,-3.15891,97.08098,684.87,33.6,10567,10437,130,1.24557
01,北海道,01693,標津町,5025,2460,2565,5242,-217,-4.13964,95.90643,624.69,8,2205,2169,36,1.65975
01,北海道,01694,羅臼町,4721,2343,2378,5415,-694,-12.81625,98.52817,397.72,11.9,1946,2101,-155,-7.37744
02,青森県,02201,青森市,275340,128099,147241,287648,-12308,-4.27884,86.99954,824.61,333.9,118293,118234,59,0.0499
02,青森県,02202,弘前市,168564,77274,91290,177411,-8847,-4.98673,84.64673,524.2,321.6,70789,71152,-363,-0.51018
02,青森県,02203,八戸市,223529,106836,116693,231257,-7728,-3.34174,91.55305,305.56,731.5,95716,93750,1966,2.09707
02,青森県,02204,黒石市,31972,14791,17181,34284,-2312,-6.74367,86.08928,217.05,147.3,11680,11770,-90,-0.76466
02,青森県,02205,五所川原市,51435,23253,28182,55181,-3746,-6.78857,82.51011,404.2,127.3,20898,21143,-245,-1.15878
02,青森県,02206,十和田市,60420,28691,31729,63429,-3009,-4.74389,90.42516,725.65,83.3,25531,25487,44,0.17264
02,青森県,02207,三沢市,39181,19611,19570,40196,-1015,-2.52513,100.2095,119.87,326.9,17259,16367,892,5.44999
02,青森県,02208,むつ市,54122,26102,28020,58493,-4371,-7.47269,93.15489,864.12,62.6,24072,24475,-403,-1.64658
02,青森県,02209,つがる市,30979,14367,16612,33316,-2337,-7.01465,86.48567,253.55,122.2,10806,10984,-178,-1.62054
02,青森県,02210,平川市,30621,14191,16430,32106,-1485,-4.6253,86.37249,346.01,88.5,10066,10129,-63,-0.62198
02,青森県,02301,平内町,10129,4818,5311,11142,-1013,-9.09173,90.71738,217.09,46.7,3793,3971,-178,-4.4825
02,青森県,02303,今別町,2335,1120,1215,2756,-421,-15.27576,92.18107,125.27,18.6,1127,1277,-150,-11.74628
02,青森県,02304,蓬田村,2543,1211,1332,2896,-353,-12.18923,90.91592,80.84,31.5,899,959,-60,-6.25652
02,青森県,02307,外ヶ浜町,5410,2532,2878,6198,-788,-12.71378,87.97776,230.3,23.5,2350,2577,-227,-8.80869
02,青森県,02321,鰺ヶ沢町,9047,4146,4901,10126,-1079,-10.65574,84.59498,343.08,26.4,3643,3851,-208,-5.40119
02,青森県,02323,深浦町,7346,3398,3948,8429,-1083,-12.8485,86.0689,488.9,15,3047,3304,-257,-7.77845
02,青森県,02343,西目屋村,1265,589,676,1415,-150,-10.60071,87.13018,246.02,5.1,437,488,-51,-10.45082
02,青森県,02361,藤崎町,14578,6752,7826,15179,-601,-3.95942,86.27651,37.29,390.9,4960,4942,18,0.36423
02,青森県,02362,大鰐町,8671,3936,4735,9676,-1005,-10.38652,83.12566,163.43,53.1,3228,3421,-193,-5.64163
02,青森県,02367,田舎館村,7328,3425,3903,7783,-455,-5.84607,87.75301,22.35,327.9,2400,2382,18,0.75567
02,青森県,02381,板柳町,12712,5806,6906,13935,-1223,-8.77646,84.07182,41.88,303.5,4476,4680,-204,-4.35897
02,青森県,02384,鶴田町,12077,5553,6524,13392,-1315,-9.8193,85.11649,46.43,260.1,4255,4384,-129,-2.94252
02,青森県,02387,中泊町,9663,4433,5230,11187,-1524,-13.62296,84.76099,216.34,44.7,3869,4118,-249,-6.04662
02,青森県,02401,野辺地町,12389,5777,6612,13524,-1135,-8.39249,87.37145,81.68,151.7,5325,5565,-240,-4.31267
02,青森県,02402,七戸町,14564,6967,7597,15709,-1145,-7.28882,91.70725,337.23,43.2,5443,5572,-129,-2.31515
02,青森県,02405,六戸町,10456,5086,5370,10423,33,0.31661,94.71136,83.89,124.6,3833,3570,263,7.36695
02,青森県,02406,横浜町,4231,2071,2160,4535,-304,-6.70342,95.87963,126.38,33.5,1813,1785,28,1.56863
02,青森県,02408,東北町,16441,7844,8597,17955,-1514,-8.43219,91.24113,326.5,50.4,5868,5974,-106,-1.77436
02,青森県,02411,六ヶ所村,10369,5910,4459,10536,-167,-1.58504,132.54093,252.68,41,5193,4683,510,10.89045
02,青森県,02412,おいらせ町,24282,11629,12653,24222,60,0.24771,91.90706,71.96,337.4,9180,8658,522,6.02911
02,青森県,02423,大間町,4718,2373,2345,5227,-509,-9.7379,101.19403,52.1,90.6,2107,2152,-45,-2.09108
02,青森県,02424,東通村,5956,3162,2794,6607,-651,-9.85319,113.17108,295.27,20.2,2559,2578,-19,-0.73701
02,青森県,02425,風間浦村,1633,774,859,1976,-343,-17.3583,90.10477,69.55,23.5,754,823,-69,-8.38396
02,青森県,02426,佐井村,1788,883,905,2148,-360,-16.75978,97.56906,135.04,13.2,824,906,-82,-9.05077
02,青森県,02441,三戸町,9090,4293,4797,10135,-1045,-10.3108,89.49343,151.79,59.9,3564,3756,-192,-5.11182
02,青森県,02442,五戸町,16051,7682,8369,17433,-1382,-7.92749,91.79113,177.67,90.3,6059,6123,-64,-1.04524
02,青森県,02443,田子町,4970,2376,2594,5554,-584,-10.51494,91.59599,241.98,20.5,1918,2006,-88,-4.38684
02,青森県,02445,南部町,16822,7884,8938,18312,-1490,-8.13674,88.20765,153.12,109.9,6260,6419,-159,-2.47702
02,青森県,02446,階上町,13506,6829,6677,14025,-519,-3.70053,102.27647,94,143.7,5862,5699,163,2.86015
02,青森県,02450,新郷村,2197,1067,1130,2509,-312,-12.43523,94.42478,150.77,14.6,787,831,-44,-5.29483
03,岩手県,03201,盛岡市,289893,136950,152943,297631,-7738,-2.59986,89.54316,886.47,327,130936,129718,1218,0.93896
03,岩手県,03202,宮古市,50401,24387,26014,56676,-6275,-11.07171,93.74568,1259.15,40,21303,23387,-2084,-8.91093
03,岩手県,03203,大船渡市,34739,16686,18053,38058,-3319,-8.7209,92.42785,322.51,107.7,14115,14807,-692,-4.67347
03,岩手県,03205,花巻市,93234,44428,48806,97702,-4468,-4.57309,91.02979,908.39,102.6,34715,33799,916,2.71014
03,岩手県,03206,北上市,93089,46855,46234,93511,-422,-0.45128,101.34317,437.55,212.8,38871,35861,3010,8.39352
03,岩手県,03207,久慈市,33063,15897,17166,35642,-2579,-7.23585,92.60748,623.5,53,14118,14256,-138,-0.96801
03,岩手県,03208,遠野市,25381,12227,13154,28062,-2681,-9.55385,92.95271,825.97,30.7,9619,9973,-354,-3.54958
03,岩手県,03209,一関市,111970,54260,57710,121583,-9613,-7.90653,94.02183,1256.42,89.1,42192,43046,-854,-1.98392
03,岩手県,03210,陸前高田市,18271,8836,9435,19758,-1487,-7.52607,93.6513,231.94,78.8,7148,7487,-339,-4.52785
03,岩手県,03211,釜石市,32096,15364,16732,36802,-4706,-12.78735,91.82405,440.35,72.9,14723,16860,-2137,-12.67497
03,岩手県,03213,二戸市,25528,11992,13536,27611,-2083,-7.54409,88.59338,420.42,60.7,10511,10670,-159,-1.49016
03,岩手県,03214,八幡平市,24042,11510,12532,26355,-2313,-8.77632,91.84488,862.3,27.9,9151,9429,-278,-2.94835
03,岩手県,03215,奥州市,113027,54862,58165,119422,-6395,-5.35496,94.32133,993.3,113.8,42303,41726,577,1.38283
03,岩手県,03216,滝沢市,55600,27143,28457,55463,137,0.24701,95.38251,182.46,304.7,21727,20787,940,4.52206
03,岩手県,03301,雫石町,15742,7500,8242,16981,-1239,-7.29639,90.99733,608.82,25.9,5426,5508,-82,-1.48874
03,岩手県,03302,葛巻町,5638,2730,2908,6344,-706,-11.12863,93.87895,434.96,13,2342,2460,-118,-4.79675
03,岩手県,03303,岩手町,12294,5971,6323,13692,-1398,-10.21034,94.43302,360.46,34.1,4773,4927,-154,-3.12563
03,岩手県,03321,紫波町,32166,15395,16771,32614,-448,-1.37364,91.79536,238.98,134.6,11370,10808,562,5.19985
03,岩手県,03322,矢巾町,28076,13345,14731,27678,398,1.43797,90.59127,67.32,417.1,10954,9902,1052,10.62412
03,岩手県,03366,西和賀町,5137,2380,2757,5880,-743,-12.63605,86.32572,590.74,8.7,1994,2146,-152,-7.08295
03,岩手県,03381,金ケ崎町,15545,8035,7510,15895,-350,-2.20195,106.99068,179.76,86.5,5919,5556,363,6.53348
03,岩手県,03402,平泉町,7258,3502,3756,7868,-610,-7.75292,93.23749,63.39,114.5,2388,2478,-90,-3.63196
03,岩手県,03441,住田町,5050,2474,2576,5720,-670,-11.71329,96.04037,334.84,15.1,1983,2117,-134,-6.32971
03,岩手県,03461,大槌町,11013,5236,5777,11759,-746,-6.34408,90.63528,200.42,54.9,4533,4927,-394,-7.99675
03,岩手県,03482,山田町,14332,6902,7430,15826,-1494,-9.44016,92.89367,262.81,54.5,5640,6218,-578,-9.29559
03,岩手県,03483,岩泉町,8732,4330,4402,9841,-1109,-11.26918,98.36438,992.36,8.8,3953,4174,-221,-5.29468
03,岩手県,03484,田野畑村,3059,1527,1532,3466,-407,-11.74264,99.67363,156.19,19.6,1233,1292,-59,-4.56656
03,岩手県,03485,普代村,2489,1246,1243,2795,-306,-10.94812,100.24135,69.66,35.7,1031,1103,-72,-6.52765
03,岩手県,03501,軽米町,8423,4090,4333,9333,-910,-9.75035,94.39188,245.82,34.3,3274,3318,-44,-1.3261
03,岩手県,03503,野田村,3938,1863,2075,4149,-211,-5.08556,89.78313,80.8,48.7,1498,1516,-18,-1.18734
03,岩手県,03506,九戸村,5376,2554,2822,5865,-489,-8.3376,90.50319,134.02,40.1,1924,1990,-66,-3.31658
03,岩手県,03507,洋野町,15098,7102,7996,16693,-1595,-9.5549,88.81941,302.92,49.8,5794,5959,-165,-2.76892
03,岩手県,03524,一戸町,11506,5503,6003,12919,-1413,-10.93738,91.67083,300.03,38.3,4553,4844,-291,-6.00743
04,宮城県,04100,仙台市,1097196,531722,565474,1082159,15037,1.38954,94.0312,786.35,1395.3,523620,498953,24667,4.94375
04,宮城県,04101,仙台市青葉区,311757,150976,160781,310183,1574,0.50744,93.90164,302.24,1031.5,161618,158562,3056,1.92732
04,宮城県,04102,仙台市宮城野区,196813,96358,100455,194825,1988,1.0204,95.92156,58.25,3378.8,95670,90166,5504,6.1043
04,宮城県,04103,仙台市若林区,141531,69634,71897,133498,8033,6.01732,96.85244,50.86,2782.8,68425,61963,6462,10.4288
04,宮城県,04104,仙台市太白区,234875,112959,121916,226855,8020,3.5353,92.65314,228.39,1028.4,104827,98456,6371,6.47091
04,宮城県,04105,仙台市泉区,212220,101795,110425,216798,-4578,-2.11164,92.18474,146.61,1447.5,93080,89806,3274,3.64564
04,宮城県,04202,石巻市,140237,68316,71921,147214,-6977,-4.73936,94.98756,554.55,252.9,56374,56819,-445,-0.78319
04,宮城県,04203,塩竈市,52249,24899,27350,54187,-1938,-3.5765,91.03839,17.37,3008,21216,20519,697,3.39685
04,宮城県,04205,気仙沼市,61171,29905,31266,64988,-3817,-5.87339,95.64703,332.44,184,24508,24152,356,1.474
04,宮城県,04206,白石市,32734,15981,16753,35272,-2538,-7.19551,95.39187,286.48,114.3,12457,12585,-128,-1.01708
04,宮城県,04207,名取市,78757,38588,40169,76668,2089,2.72474,96.06413,98.18,802.2,29675,27529,2146,7.79542
04,宮城県,04208,角田市,27996,13806,14190,30180,-2184,-7.23658,97.29387,147.53,189.8,10262,10398,-136,-1.30794
04,宮城県,04209,多賀城市,63276,31566,31710,62096,1180,1.90028,99.54588,19.69,3213.6,26482,24097,2385,9.8975
04,宮城県,04211,岩沼市,44091,21693,22398,44678,-587,-1.31385,96.8524,60.45,729.4,17234,16631,603,3.62576
04,宮城県,04212,登米市,76103,37159,38944,81959,-5856,-7.14504,95.4165,536.12,142,25605,26196,-591,-2.25607
04,宮城県,04213,栗原市,64686,31144,33542,69906,-5220,-7.46717,92.85075,804.97,80.4,22696,23133,-437,-1.88908
04,宮城県,04214,東松島市,39121,19096,20025,39503,-382,-0.96702,95.3608,101.3,386.2,14429,13868,561,4.04528
04,宮城県,04215,大崎市,127381,62428,64953,133391,-6010,-4.50555,96.11257,796.81,159.9,48780,48307,473,0.97915
04,宮城県,04216,富谷市,51659,25091,26568,51591,68,0.13181,94.44068,49.18,1050.4,18378,17494,884,5.05316
04,宮城県,04301,蔵王町,11428,5572,5856,12316,-888,-7.21013,95.15027,152.83,74.8,3916,3923,-7,-0.17843
04,宮城県,04302,七ヶ宿町,1262,620,642,1461,-199,-13.62081,96.57321,263.09,4.8,523,567,-44,-7.76014
04,宮城県,04321,大河原町,23575,11528,12047,23798,-223,-0.93705,95.69187,24.99,943.4,9516,9099,417,4.58292
04,宮城県,04322,村田町,10670,5296,5374,11501,-831,-7.22546,98.54857,78.38,136.1,3764,3764,0,0
04,宮城県,04323,柴田町,38264,19344,18920,39525,-1261,-3.19039,102.24101,54.03,708.2,15530,15121,409,2.70485
04,宮城県,04324,川崎町,8353,4101,4252,9167,-814,-8.87968,96.44873,270.77,30.8,2956,2880,76,2.63889
04,宮城県,04341,丸森町,12268,6121,6147,13972,-1704,-12.19582,99.57703,273.3,44.9,4423,4547,-124,-2.72707
04,宮城県,04361,亘理町,33098,16212,16886,33589,-491,-1.46179,96.00853,73.6,449.7,12153,11334,819,7.22605
04,宮城県,04362,山元町,12051,5976,6075,12315,-264,-2.14373,98.37037,64.58,186.6,4540,4429,111,2.50621
04,宮城県,04401,松島町,13341,6423,6918,14421,-1080,-7.48908,92.84475,53.56,249.1,5002,5112,-110,-2.1518
04,宮城県,04404,七ヶ浜町,18136,9026,9110,18652,-516,-2.76646,99.07794,13.19,1375,6445,6167,278,4.50786
04,宮城県,04406,利府町,35189,17206,17983,35835,-646,-1.80271,95.67925,44.89,783.9,12527,12191,336,2.75613
04,宮城県,04421,大和町,28786,14971,13815,28244,542,1.91899,108.36772,225.49,127.7,11382,10177,1205,11.84042
04,宮城県,04422,大郷町,7825,3822,4003,8370,-545,-6.51135,95.47839,82.01,95.4,2483,2421,62,2.56093
04,宮城県,04424,大衡村,5849,2928,2921,5703,146,2.56006,100.23964,60.32,97,1878,1755,123,7.00855
04,宮城県,04444,色麻町,6709,3250,3459,7238,-529,-7.30865,93.95779,109.28,61.4,1965,1974,-9,-0.45593
04,宮城県,04445,加美町,21952,10766,11186,23743,-1791,-7.54328,96.24531,460.67,47.7,7641,7564,77,1.01798
04,宮城県,04501,涌谷町,15401,7524,7877,16701,-1300,-7.78397,95.5186,82.16,187.5,5450,5476,-26,-0.4748
04,宮城県,04505,美里町,24011,11615,12396,24852,-841,-3.38403,93.69958,74.99,320.2,8533,8343,190,2.27736
04,宮城県,04581,女川町,6432,3351,3081,6334,98,1.54721,108.76339,65.35,98.4,3165,3154,11,0.34876
04,宮城県,04606,南三陸町,12230,5964,6266,12370,-140,-1.13177,95.18034,163.4,74.8,4283,4041,242,5.98862
05,秋田県,05201,秋田市,307885,145423,162462,315814,-7929,-2.51066,89.51201,906.07,339.8,136942,135318,1624,1.20014
05,秋田県,05202,能代市,50005,22914,27091,54730,-4725,-8.63329,84.5816,426.95,117.1,21220,22371,-1151,-5.14505
05,秋田県,05203,横手市,85584,40336,45248,92197,-6613,-7.17268,89.14427,692.8,123.5,31099,31463,-364,-1.15691
05,秋田県,05204,大館市,69280,32556,36724,74175,-4895,-6.59926,88.65047,913.22,75.9,27999,28242,-243,-0.86042
05,秋田県,05206,男鹿市,25175,11855,13320,28375,-3200,-11.27753,89.0015,241.09,104.4,10491,11147,-656,-5.88499
05,秋田県,05207,湯沢市,42096,20112,21984,46613,-4517,-9.69043,91.48472,790.91,53.2,15686,16384,-698,-4.26025
05,秋田県,05209,鹿角市,29107,13677,15430,32038,-2931,-9.14851,88.63901,707.52,41.1,10979,11508,-529,-4.5968
05,秋田県,05210,由利本荘市,74763,35860,38903,79927,-5164,-6.4609,92.17798,1209.59,61.8,28313,28349,-36,-0.12699
05,秋田県,05211,潟上市,31743,14979,16764,33083,-1340,-4.05042,89.35218,97.72,324.8,12279,12023,256,2.12925
05,秋田県,05212,大仙市,77715,36298,41417,82783,-5068,-6.12203,87.64034,866.79,89.7,28429,28198,231,0.81921
05,秋田県,05213,北秋田市,30217,14165,16052,33224,-3007,-9.05069,88.24446,1152.76,26.2,12079,12222,-143,-1.17002
05,秋田県,05214,にかほ市,23455,11231,12224,25324,-1869,-7.38035,91.87664,241.13,97.3,8632,8804,-172,-1.95366
05,秋田県,05215,仙北市,24629,11400,13229,27523,-2894,-10.51484,86.17431,1093.56,22.5,9247,9594,-347,-3.61684
05,秋田県,05303,小坂町,4780,2232,2548,5339,-559,-10.47013,87.59812,201.7,23.7,2044,2168,-124,-5.71956
05,秋田県,05327,上小阿仁村,2069,987,1082,2381,-312,-13.10374,91.21996,256.72,8.1,831,918,-87,-9.47712
05,秋田県,05346,藤里町,2898,1381,1517,3359,-461,-13.72432,91.03494,282.13,10.3,1124,1215,-91,-7.48971
05,秋田県,05348,三種町,15266,7036,8230,17078,-1812,-10.61014,85.4921,247.98,61.6,5749,6010,-261,-4.34276
05,秋田県,05349,八峰町,6582,3068,3514,7309,-727,-9.94664,87.30791,234.14,28.1,2615,2706,-91,-3.3629
05,秋田県,05361,五城目町,8544,3983,4561,9463,-919,-9.71151,87.32734,214.92,39.8,3351,3573,-222,-6.21327
05,秋田県,05363,八郎潟町,5582,2533,3049,6080,-498,-8.19079,83.07642,17,328.4,2139,2220,-81,-3.64865
05,秋田県,05366,井川町,4570,2131,2439,4986,-416,-8.34336,87.37187,47.95,95.3,1529,1563,-34,-2.1753
05,秋田県,05368,大潟村,3014,1498,1516,3110,-96,-3.08682,98.81266,170.11,17.7,834,796,38,4.77387
05,秋田県,05434,美郷町,18625,8698,9927,20279,-1654,-8.15622,87.61962,168.32,110.7,5994,6152,-158,-2.56827
05,秋田県,05463,羽後町,13822,6635,7187,15319,-1497,-9.77218,92.31947,230.78,59.9,4659,4807,-148,-3.07884
05,秋田県,05464,東成瀬村,2707,1491,1216,2610,97,3.71648,122.61513,203.69,13.3,1158,809,349,43.13968
06,山形県,06201,山形市,247747,119022,128725,253832,-6085,-2.39725,92.46223,381.3,649.7,102531,100303,2228,2.22127
06,山形県,06202,米沢市,81326,40259,41067,85953,-4627,-5.38317,98.03248,548.51,148.3,33077,32997,80,0.24245
06,山形県,06203,鶴岡市,122454,58641,63813,129652,-7198,-5.55178,91.89507,1311.53,93.4,45780,45339,441,0.97267
06,山形県,06204,酒田市,100320,47855,52465,106244,-5924,-5.57584,91.21319,602.97,166.4,39425,39320,105,0.26704
06,山形県,06205,新庄市,34445,16442,18003,36894,-2449,-6.63794,91.32922,222.85,154.6,12819,12961,-142,-1.09559
06,山形県,06206,寒河江市,40208,19530,20678,41256,-1048,-2.54024,94.44821,139.03,289.2,13655,13086,569,4.34816
06,山形県,06207,上山市,29139,13918,15221,31569,-2430,-7.69742,91.43946,240.93,120.9,10557,10694,-137,-1.28109
06,山形県,06208,村山市,22537,10939,11598,24684,-2147,-8.69794,94.31799,196.98,114.4,7579,7713,-134,-1.73733
06,山形県,06209,長井市,26564,12959,13605,27757,-1193,-4.29801,95.25175,214.67,123.7,9481,9109,372,4.08387
06,山形県,06210,天童市,62166,30220,31946,62194,-28,-0.04502,94.59713,113.01,550.1,22556,21428,1128,5.26414
06,山形県,06211,東根市,47725,23532,24193,47768,-43,-0.09002,97.2678,206.94,230.6,16537,15473,1064,6.87649
06,山形県,06212,尾花沢市,14984,7329,7655,16953,-1969,-11.61446,95.74135,372.53,40.2,4881,5109,-228,-4.46271
06,山形県,06213,南陽市,30437,14658,15779,32285,-1848,-5.72402,92.89562,160.52,189.6,10754,10705,49,0.45773
06,山形県,06301,山辺町,13732,6604,7128,14369,-637,-4.43315,92.64871,61.45,223.5,4546,4440,106,2.38739
06,山形県,06302,中山町,10751,5251,5500,11363,-612,-5.3859,95.47273,31.15,345.1,3514,3427,87,2.53866
06,山形県,06321,河北町,17649,8528,9121,18952,-1303,-6.87526,93.49852,52.45,336.5,5944,5865,79,1.34697
06,山形県,06322,西川町,4965,2389,2576,5636,-671,-11.90561,92.74068,393.19,12.6,1686,1785,-99,-5.54622
06,山形県,06323,朝日町,6371,3152,3219,7119,-748,-10.50709,97.91861,196.81,32.4,2151,2242,-91,-4.05888
06,山形県,06324,大江町,7650,3798,3852,8472,-822,-9.70255,98.59813,154.08,49.6,2537,2632,-95,-3.60942
06,山形県,06341,大石田町,6581,3215,3366,7357,-776,-10.54778,95.51396,79.54,82.7,2086,2143,-57,-2.65982
06,山形県,06361,金山町,5074,2466,2608,5829,-755,-12.95248,94.55521,161.67,31.4,1633,1643,-10,-0.60864
06,山形県,06362,最上町,8097,3914,4183,8902,-805,-9.04291,93.56921,330.37,24.5,2674,2665,9,0.33771
06,山形県,06363,舟形町,5007,2420,2587,5631,-624,-11.08151,93.54465,119.04,42.1,1567,1621,-54,-3.33128
06,山形県,06364,真室川町,7205,3408,3797,8137,-932,-11.45385,89.75507,374.22,19.3,2308,2478,-170,-6.86037
06,山形県,06365,大蔵村,3030,1500,1530,3412,-382,-11.19578,98.03922,211.63,14.3,947,1016,-69,-6.79134
06,山形県,06366,鮭川村,3904,1888,2016,4317,-413,-9.56683,93.65079,122.14,32,1193,1224,-31,-2.53268
06,山形県,06367,戸沢村,4203,1989,2214,4773,-570,-11.94217,89.8374,261.31,16.1,1360,1390,-30,-2.15827
06,山形県,06381,高畠町,22471,10952,11519,23882,-1411,-5.90822,95.0777,180.26,124.7,7357,7218,139,1.92574
06,山形県,06382,川西町,14541,7090,7451,15751,-1210,-7.68205,95.15501,166.6,87.3,4493,4553,-60,-1.31781
06,山形県,06401,小国町,7108,3573,3535,7868,-760,-9.65938,101.07496,737.56,9.6,2809,2845,-36,-1.26538
06,山形県,06402,白鷹町,12897,6357,6540,14175,-1278,-9.01587,97.20183,157.71,81.8,4387,4405,-18,-0.40863
06,山形県,06403,飯豊町,6615,3218,3397,7304,-689,-9.43319,94.73064,329.41,20.1,2125,2198,-73,-3.3212
06,山形県,06426,三川町,7600,3692,3908,7728,-128,-1.65631,94.47288,33.22,228.8,2331,2223,108,4.8583
06,山形県,06428,庄内町,20160,9631,10529,21666,-1506,-6.95098,91.47117,249.17,80.9,6647,6637,10,0.15067
06,山形県,06461,遊佐町,13033,6190,6843,14207,-1174,-8.26353,90.4574,208.39,62.5,4431,4509,-78,-1.72987
07,福島県,07201,福島市,282802,138208,144594,294247,-11445,-3.88959,95.5835,767.72,368.4,121342,122269,-927,-0.75816
07,福島県,07202,会津若松市,117433,56059,61374,124062,-6629,-5.3433,91.33998,382.97,306.6,49043,49431,-388,-0.78493
07,福島県,07203,郡山市,327872,161876,165996,335444,-7572,-2.25731,97.51801,757.2,433,140132,138310,1822,1.31733
07,福島県,07204,いわき市,333202,163591,169611,350237,-17035,-4.86385,96.4507,1232.26,270.4,141173,141069,104,0.07372
07,福島県,07205,白河市,59531,29690,29841,61913,-2382,-3.84733,99.49398,305.32,195,23718,23004,714,3.10381
07,福島県,07207,須賀川市,75039,36790,38249,77441,-2402,-3.10172,96.18552,279.43,268.5,27072,26345,727,2.75954
07,福島県,07208,喜多方市,44810,21440,23370,49377,-4567,-9.24925,91.74155,554.63,80.8,16025,16752,-727,-4.33978
07,福島県,07209,相馬市,34884,17554,17330,38556,-3672,-9.52381,101.29256,197.79,176.4,13900,15209,-1309,-8.60675
07,福島県,07210,二本松市,53593,26314,27279,58162,-4569,-7.85564,96.46248,344.42,155.6,19359,19810,-451,-2.27663
07,福島県,07211,田村市,35192,17329,17863,38503,-3311,-8.59933,97.01058,458.33,76.8,12131,12734,-603,-4.73535
07,福島県,07212,南相馬市,59053,31021,28032,57797,1256,2.17312,110.66281,398.58,148.2,26342,25944,398,1.53407
07,福島県,07213,伊達市,58250,28300,29950,62400,-4150,-6.65064,94.49082,265.12,219.7,21149,21624,-475,-2.19663
07,福島県,07214,本宮市,30240,15015,15225,30924,-684,-2.21187,98.62069,88.02,343.6,10543,10049,494,4.91591
07,福島県,07301,桑折町,11464,5492,5972,12271,-807,-6.57648,91.96249,42.97,266.8,4180,4276,-96,-2.24509
07,福島県,07303,国見町,8641,4111,4530,9512,-871,-9.15685,90.75055,37.95,227.7,3124,3291,-167,-5.07445
07,福島県,07308,川俣町,12186,5994,6192,14452,-2266,-15.67949,96.80233,127.7,95.4,4777,5515,-738,-13.38169
07,福島県,07322,大玉村,8904,4427,4477,8679,225,2.59246,98.88318,79.44,112.1,2872,2619,253,9.66018
07,福島県,07342,鏡石町,12316,6029,6287,12486,-170,-1.36152,95.89629,31.3,393.5,4356,4205,151,3.59096
07,福島県,07344,天栄村,5198,2567,2631,5611,-413,-7.36054,97.56746,225.52,23,1668,1638,30,1.8315
07,福島県,07362,下郷町,5267,2601,2666,5800,-533,-9.18966,97.56189,317.04,16.6,1954,2002,-48,-2.3976
07,福島県,07364,檜枝岐村,507,261,246,615,-108,-17.56098,106.09756,390.46,1.3,228,257,-29,-11.28405
07,福島県,07367,只見町,4041,1974,2067,4470,-429,-9.59732,95.50073,747.56,5.4,1633,1762,-129,-7.32123
07,福島県,07368,南会津町,14453,7124,7329,16264,-1811,-11.13502,97.20289,886.47,16.3,5892,6246,-354,-5.66763
07,福島県,07402,北塩原村,2554,1290,1264,2831,-277,-9.78453,102.05696,234.08,10.9,1002,1008,-6,-0.59524
07,福島県,07405,西会津町,5765,2789,2976,6582,-817,-12.41264,93.7164,298.18,19.3,2352,2531,-179,-7.0723
07,福島県,07407,磐梯町,3332,1607,1725,3579,-247,-6.90137,93.15942,59.77,55.7,1079,1117,-38,-3.40197
07,福島県,07408,猪苗代町,13559,6532,7027,15037,-1478,-9.82909,92.95574,394.85,34.3,4714,4939,-225,-4.55558
07,福島県,07421,会津坂下町,15068,7241,7827,16303,-1235,-7.57529,92.5131,91.59,164.5,5288,5391,-103,-1.91059
07,福島県,07422,湯川村,3082,1485,1597,3206,-124,-3.86775,92.98685,16.37,188.3,976,906,70,7.72627
07,福島県,07423,柳津町,3087,1500,1587,3536,-449,-12.69796,94.51796,175.82,17.6,1126,1207,-81,-6.71085
07,福島県,07444,三島町,1457,717,740,1668,-211,-12.64988,96.89189,90.81,16,651,674,-23,-3.41246
07,福島県,07445,金山町,1867,911,956,2189,-322,-14.70991,95.29289,293.92,6.4,878,956,-78,-8.159
07,福島県,07446,昭和村,1247,622,625,1322,-75,-5.67322,99.52,209.46,6,626,616,10,1.62338
07,福島県,07447,会津美里町,19030,9114,9916,20913,-1883,-9.00397,91.91206,276.33,68.9,6457,6710,-253,-3.77049
07,福島県,07461,西郷村,20809,10640,10169,20322,487,2.39642,104.63172,192.06,108.3,8055,7458,597,8.00483
07,福島県,07464,泉崎村,6214,3064,3150,6495,-281,-4.3264,97.26984,35.43,175.4,2056,2059,-3,-0.1457
07,福島県,07465,中島村,4889,2398,2491,5001,-112,-2.23955,96.26656,18.92,258.4,1514,1395,119,8.53047
07,福島県,07466,矢吹町,17307,8658,8649,17370,-63,-0.36269,100.10406,60.4,286.5,6063,5846,217,3.71194
07,福島県,07481,棚倉町,13330,6577,6753,14295,-965,-6.75061,97.39375,159.93,83.3,4735,4753,-18,-0.37871
07,福島県,07482,矢祭町,5404,2625,2779,5950,-546,-9.17647,94.45844,118.27,45.7,1870,1921,-51,-2.65487
07,福島県,07483,塙町,8321,4074,4247,9157,-836,-9.12963,95.92654,211.41,39.4,2942,3043,-101,-3.31909
07,福島県,07484,鮫川村,3058,1532,1526,3577,-519,-14.50937,100.39318,131.34,23.3,1010,1064,-54,-5.07519
07,福島県,07501,石川町,14655,7337,7318,15880,-1225,-7.71411,100.25963,115.71,126.7,5212,5244,-32,-0.61022
07,福島県,07502,玉川村,6403,3204,3199,6777,-374,-5.51867,100.1563,46.67,137.2,1981,1974,7,0.35461
07,福島県,07503,平田村,5830,2884,2946,6505,-675,-10.37663,97.89545,93.42,62.4,1968,1989,-21,-1.05581
07,福島県,07504,浅川町,6041,3032,3009,6577,-536,-8.14961,100.76437,37.43,161.4,2067,2055,12,0.58394
07,福島県,07505,古殿町,4826,2369,2457,5373,-547,-10.18053,96.4184,163.29,29.6,1604,1661,-57,-3.43167
07,福島県,07521,三春町,17026,8452,8574,18304,-1278,-6.98208,98.57709,72.76,234,5975,6230,-255,-4.0931
07,福島県,07522,小野町,9482,4676,4806,10475,-993,-9.47971,97.29505,125.18,75.7,3372,3425,-53,-1.54745
07,福島県,07541,広野町,5408,3304,2104,4319,1089,25.21417,157.03422,58.69,92.1,2895,2435,460,18.89117
07,福島県,07542,楢葉町,3700,2138,1562,975,2725,279.48718,136.8758,103.64,35.7,1964,839,1125,134.0882
07,福島県,07543,富岡町,2130,1543,587,-,2130,-,262.86201,68.39,31.1,1633,-,1633,-
07,福島県,07544,川内村,2046,1028,1018,2021,25,1.23701,100.98232,197.35,10.4,929,1082,-153,-14.14048
07,福島県,07545,大熊町,847,756,91,-,847,-,830.76923,78.71,10.8,808,-,808,-
07,福島県,07546,双葉町,-,-,-,-,0,-,-,51.42,0,-,-,0,-
07,福島県,07547,浪江町,1896,1346,550,-,1896,-,244.72727,223.14,8.5,1405,-,1405,-
07,福島県,07548,葛尾村,421,241,180,18,403,2238.88889,133.88889,84.37,5,205,9,196,2177.77778
07,福島県,07561,新地町,7910,3945,3965,8218,-308,-3.74787,99.49559,46.7,169.4,2749,2699,50,1.85254
07,福島県,07564,飯舘村,1319,664,655,41,1278,3117.07317,101.37405,230.13,5.7,626,1,625,62500
08,茨城県,08201,水戸市,270810,132547,138263,270783,27,0.00997,95.86585,217.32,1246.1,122218,117590,4628,3.93571
08,茨城県,08202,日立市,174635,87139,87496,185054,-10419,-5.63025,99.59198,225.86,773.2,77813,78625,-812,-1.03275
08,茨城県,08203,土浦市,142160,70962,71198,140804,1356,0.96304,99.66853,122.89,1156.8,62693,57257,5436,9.49404
08,茨城県,08204,古河市,139396,69746,69650,140946,-1550,-1.09971,100.13783,123.58,1128,55895,52571,3324,6.32288
08,茨城県,08205,石岡市,73160,36193,36967,76020,-2860,-3.76217,97.90624,215.53,339.4,28246,27288,958,3.5107
08,茨城県,08207,結城市,50627,25421,25206,51594,-967,-1.87425,100.85297,65.76,769.9,19189,18267,922,5.04735
08,茨城県,08208,龍ケ崎市,76455,38010,38445,78342,-1887,-2.40867,98.86851,78.59,972.8,31960,30472,1488,4.88317
08,茨城県,08210,下妻市,42554,21421,21133,43293,-739,-1.70697,101.3628,80.88,526.1,16350,15036,1314,8.73903
08,茨城県,08211,常総市,60890,30479,30411,61483,-593,-0.96449,100.2236,123.64,492.5,22087,20600,1487,7.21845
08,茨城県,08212,常陸太田市,48630,23710,24920,52294,-3664,-7.00654,95.14446,371.99,130.7,19239,19436,-197,-1.01358
08,茨城県,08214,高萩市,27722,13807,13915,29638,-1916,-6.46467,99.22386,193.58,143.2,11613,11751,-138,-1.17437
08,茨城県,08215,北茨城市,41836,20760,21076,44412,-2576,-5.80023,98.50066,186.79,224,17029,16871,158,0.93652
08,茨城県,08216,笠間市,73241,35797,37444,76739,-3498,-4.55831,95.60143,240.4,304.7,28871,28202,669,2.37217
08,茨城県,08217,取手市,104545,51472,53073,106570,-2025,-1.90016,96.9834,69.94,1494.8,45361,43477,1884,4.33333
08,茨城県,08219,牛久市,84677,41776,42901,84317,360,0.42696,97.37768,58.92,1437.2,35147,33223,1924,5.79117
08,茨城県,08220,つくば市,241785,121071,120714,226963,14822,6.53058,100.29574,283.72,852.2,111019,98190,12829,13.06549
08,茨城県,08221,ひたちなか市,156664,79298,77366,155689,975,0.62625,102.49722,99.97,1567.1,66639,61104,5535,9.05833
08,茨城県,08222,鹿嶋市,66965,34440,32525,67879,-914,-1.34651,105.88778,106.02,631.6,28230,27450,780,2.84153
08,茨城県,08223,潮来市,27624,13674,13950,29111,-1487,-5.10803,98.02151,71.4,386.9,10768,10547,221,2.09538
08,茨城県,08224,守谷市,68426,34151,34275,64753,3673,5.67232,99.63822,35.71,1916.2,27243,24867,2376,9.55483
08,茨城県,08225,常陸大宮市,39294,19394,19900,42587,-3293,-7.73241,97.45729,348.45,112.8,15630,16005,-375,-2.34302
08,茨城県,08226,那珂市,53530,26045,27485,54276,-746,-1.37446,94.76078,97.82,547.2,20909,20025,884,4.41448
08,茨城県,08227,筑西市,100819,50025,50794,104573,-3754,-3.58984,98.48604,205.3,491.1,37298,35683,1615,4.52596
08,茨城県,08228,坂東市,52292,26591,25701,54087,-1795,-3.31873,103.4629,123.03,425,18127,17327,800,4.61707
08,茨城県,08229,稲敷市,39079,19500,19579,42810,-3731,-8.71525,99.59651,205.81,189.9,14493,14453,40,0.27676
08,茨城県,08230,かすみがうら市,40114,20349,19765,42147,-2033,-4.82359,102.95472,156.6,256.2,15188,15142,46,0.30379
08,茨城県,08231,桜川市,39159,19370,19789,42632,-3473,-8.14646,97.88266,180.06,217.5,13415,13585,-170,-1.25138
08,茨城県,08232,神栖市,95466,49394,46072,94522,944,0.99871,107.21045,146.97,649.6,40427,37221,3206,8.61342
08,茨城県,08233,行方市,32215,15980,16235,34909,-2694,-7.71721,98.42932,222.48,144.8,11152,11115,37,0.33288
08,茨城県,08234,鉾田市,45973,23369,22604,48147,-2174,-4.51534,103.38436,207.6,221.4,17963,17430,533,3.05795
08,茨城県,08235,つくばみらい市,49898,24888,25010,49136,762,1.5508,99.5122,79.16,630.3,19936,18137,1799,9.91895
08,茨城県,08236,小美玉市,48902,24592,24310,50911,-2009,-3.9461,101.16002,144.74,337.9,18365,17491,874,4.99686
08,茨城県,08302,茨城町,31417,15565,15852,32921,-1504,-4.56851,98.1895,121.58,258.4,11715,11356,359,3.16132
08,茨城県,08309,大洗町,15725,7792,7933,16886,-1161,-6.87552,98.22261,23.89,658.2,6550,6661,-111,-1.66642
08,茨城県,08310,城里町,18109,8914,9195,19800,-1691,-8.5404,96.94399,161.8,111.9,6911,7066,-155,-2.1936
08,茨城県,08341,東海村,37900,19237,18663,37713,187,0.49585,103.0756,38,997.4,15411,14494,917,6.32676
08,茨城県,08364,大子町,15744,7691,8053,18053,-2309,-12.79012,95.50478,325.76,48.3,6352,6733,-381,-5.6587
08,茨城県,08442,美浦村,14611,7482,7129,15842,-1231,-7.77048,104.95161,66.61,219.4,5843,5958,-115,-1.93018
08,茨城県,08443,阿見町,48578,24247,24331,47535,1043,2.19417,99.65476,71.4,680.4,20218,18801,1417,7.53683
08,茨城県,08447,河内町,8233,4050,4183,9168,-935,-10.19852,96.82046,44.3,185.8,2867,2950,-83,-2.81356
08,茨城県,08521,八千代町,21034,10992,10042,22021,-987,-4.48209,109.46027,58.99,356.6,7028,6799,229,3.36814
08,茨城県,08542,五霞町,8100,4070,4030,8786,-686,-7.80788,100.99256,23.11,350.5,2918,2894,24,0.8293
08,茨城県,08546,境町,24208,12269,11939,24517,-309,-1.26035,102.76405,46.59,519.6,8707,8061,646,8.01389
08,茨城県,08564,利根町,15352,7485,7867,16313,-961,-5.89101,95.14427,24.86,617.5,6240,6138,102,1.66178
09,栃木県,09201,宇都宮市,519026,259636,259390,518594,432,0.0833,100.09484,416.85,1245.1,230134,217419,12715,5.84815
09,栃木県,09202,足利市,144796,71427,73369,149452,-4656,-3.11538,97.35311,177.76,814.6,61353,60186,1167,1.93899
09,栃木県,09203,栃木市,155628,77412,78216,159211,-3583,-2.25047,98.97208,331.5,469.5,60526,57838,2688,4.64746
09,栃木県,09204,佐野市,116220,57503,58717,118919,-2699,-2.26961,97.93246,356.04,326.4,48079,46390,1689,3.64087
09,栃木県,09205,鹿沼市,94074,46592,47482,98374,-4300,-4.37107,98.12561,490.64,191.7,35997,35079,918,2.61695
09,栃木県,09206,日光市,77651,37815,39836,83386,-5735,-6.87765,94.9267,1449.83,53.6,32196,32658,-462,-1.41466
09,栃木県,09208,小山市,166791,84531,82260,166760,31,0.01859,102.76076,171.75,971.1,69030,65792,3238,4.92157
09,栃木県,09209,真岡市,78221,39472,38749,79539,-1318,-1.65705,101.86585,167.34,467.4,29276,27949,1327,4.74793
09,栃木県,09210,大田原市,72123,35407,36716,75457,-3334,-4.41841,96.4348,354.36,203.5,29734,28753,981,3.41182
09,栃木県,09211,矢板市,31175,15411,15764,33354,-2179,-6.53295,97.76072,170.46,182.9,12000,12342,-342,-2.77103
09,栃木県,09213,那須塩原市,115282,57295,57987,117146,-1864,-1.59118,98.80663,592.74,194.5,47288,45608,1680,3.68356
09,栃木県,09214,さくら市,44541,23105,21436,44901,-360,-0.80176,107.78597,125.63,354.5,16325,15648,677,4.32643
09,栃木県,09215,那須烏山市,24886,12384,12502,27047,-2161,-7.9898,99.05615,174.35,142.7,9199,9439,-240,-2.54264
09,栃木県,09216,下野市,59479,29457,30022,59431,48,0.08077,98.11805,74.59,797.4,23198,21394,1804,8.43227
09,栃木県,09301,上三川町,30810,15855,14955,31046,-236,-0.76016,106.01805,54.39,566.5,11516,10777,739,6.8572
09,栃木県,09342,益子町,21906,10872,11034,23281,-1375,-5.9061,98.53181,89.4,245,7784,7787,-3,-0.03853
09,栃木県,09343,茂木町,11899,5878,6021,13188,-1289,-9.77404,97.62498,172.69,68.9,4446,4572,-126,-2.75591
09,栃木県,09344,市貝町,11259,5754,5505,11720,-461,-3.93345,104.52316,64.25,175.2,4378,4109,269,6.54661
09,栃木県,09345,芳賀町,14968,7539,7429,15189,-221,-1.455,101.48068,70.16,213.3,5217,4957,260,5.24511
09,栃木県,09361,壬生町,39509,19449,20060,39951,-442,-1.10636,96.95414,61.06,647.1,15557,15258,299,1.95963
09,栃木県,09364,野木町,24906,12396,12510,25292,-386,-1.52617,99.08873,30.27,822.8,9829,9530,299,3.13746
09,栃木県,09384,塩谷町,10366,5140,5226,11495,-1129,-9.82166,98.35438,176.06,58.9,3625,3696,-71,-1.921
09,栃木県,09386,高根沢町,29253,15254,13999,29639,-386,-1.30234,108.96493,70.87,412.8,12232,11521,711,6.17134
09,栃木県,09407,那須町,24021,11789,12232,24919,-898,-3.60368,96.37835,372.34,64.5,9143,8564,579,6.76086
09,栃木県,09411,那珂川町,15226,7685,7541,16964,-1738,-10.24523,101.90956,192.78,79,5691,5831,-140,-2.40096
10,群馬県,10201,前橋市,332332,162343,169989,336154,-3822,-1.13698,95.50206,311.59,1066.6,141354,136900,4454,3.25347
10,群馬県,10202,高崎市,373218,182706,190512,370884,2334,0.62931,95.90262,459.16,812.8,160752,150180,10572,7.03955
10,群馬県,10203,桐生市,106524,51415,55109,114714,-8190,-7.13949,93.29692,274.45,388.1,44909,46034,-1125,-2.44385
10,群馬県,10204,伊勢崎市,211975,106389,105586,208814,3161,1.51379,100.76052,139.44,1520.2,85565,80110,5455,6.80939
10,群馬県,10205,太田市,223150,114134,109016,219807,3343,1.52088,104.69472,175.54,1271.2,91492,86267,5225,6.05678
10,群馬県,10206,沼田市,45382,21942,23440,48676,-3294,-6.7672,93.60922,443.46,102.3,18826,19178,-352,-1.83544
10,群馬県,10207,館林市,75335,37770,37565,76667,-1332,-1.73738,100.54572,60.97,1235.6,31534,30219,1315,4.35157
10,群馬県,10208,渋川市,74614,36352,38262,78391,-3777,-4.81816,95.0081,240.27,310.5,29069,28812,257,0.89199
10,群馬県,10209,藤岡市,63299,30782,32517,65708,-2409,-3.66622,94.66433,180.29,351.1,25271,24569,702,2.85726
10,群馬県,10210,富岡市,47470,23407,24063,49746,-2276,-4.57524,97.27382,122.85,386.4,18499,18255,244,1.33662
10,群馬県,10211,安中市,54962,26862,28100,58531,-3569,-6.09762,95.59431,276.31,198.9,22021,22381,-360,-1.60851
10,群馬県,10212,みどり市,49663,24570,25093,50906,-1243,-2.44176,97.91575,208.42,238.3,19408,18867,541,2.86744
10,群馬県,10344,榛東村,14222,7188,7034,14329,-107,-0.74674,102.18937,27.92,509.4,5109,4887,222,4.54266
10,群馬県,10345,吉岡町,21817,10618,11199,21080,737,3.4962,94.81204,20.46,1066.3,7847,7289,558,7.65537
10,群馬県,10366,上野村,1128,571,557,1230,-102,-8.29268,102.51346,181.85,6.2,552,578,-26,-4.49827
10,群馬県,10367,神流町,1645,793,852,1954,-309,-15.81372,93.07512,114.6,14.4,825,903,-78,-8.63787
10,群馬県,10382,下仁田町,6583,3225,3358,7564,-981,-12.96933,96.03931,188.38,34.9,2863,3040,-177,-5.82237
10,群馬県,10383,南牧村,1612,763,849,1979,-367,-18.54472,89.87044,118.83,13.6,801,953,-152,-15.94963
10,群馬県,10384,甘楽町,12481,6181,6300,13200,-719,-5.44697,98.11111,58.61,213,4642,4539,103,2.26922
10,群馬県,10421,中之条町,15396,7499,7897,16850,-1454,-8.62908,94.96011,439.28,35,6350,6529,-179,-2.74161
10,群馬県,10424,長野原町,5102,2530,2572,5536,-434,-7.8396,98.36703,133.85,38.1,2189,2322,-133,-5.72782
10,群馬県,10425,嬬恋村,8861,4523,4338,9780,-919,-9.39673,104.26464,337.58,26.2,3523,3664,-141,-3.84825
10,群馬県,10426,草津町,6070,3050,3020,6518,-448,-6.87327,100.99338,49.75,122,3212,3275,-63,-1.92366
10,群馬県,10428,高山村,3518,1747,1771,3674,-156,-4.24605,98.64483,64.18,54.8,1484,1167,317,27.16367
10,群馬県,10429,東吾妻町,12741,6272,6469,14033,-1292,-9.20687,96.95471,253.91,50.2,5136,5235,-99,-1.89112
10,群馬県,10443,片品村,3994,1948,2046,4390,-396,-9.0205,95.21017,391.76,10.2,1645,1554,91,5.85586
10,群馬県,10444,川場村,3485,1593,1892,3647,-162,-4.44201,84.19662,85.25,40.9,997,980,17,1.73469
10,群馬県,10448,昭和村,6962,3456,3506,7347,-385,-5.24023,98.57387,64.14,108.5,2612,2476,136,5.49273
10,群馬県,10449,みなかみ町,17233,8357,8876,19347,-2114,-10.92676,94.15277,781.08,22.1,6972,7594,-622,-8.19068
10,群馬県,10464,玉村町,36073,17594,18479,36654,-581,-1.58509,95.21078,25.78,1399.3,14798,14337,461,3.21546
10,群馬県,10521,板倉町,14101,7029,7072,15015,-914,-6.08725,99.39197,41.86,336.9,5374,5365,9,0.16775
10,群馬県,10522,明和町,10884,5466,5418,11044,-160,-1.44875,100.88594,19.64,554.2,4080,3914,166,4.24119
10,群馬県,10523,千代田町,10857,5469,5388,11318,-461,-4.07316,101.50334,21.73,499.6,4012,3981,31,0.7787
10,群馬県,10524,大泉町,42107,22284,19823,41202,905,2.1965,112.41487,18.03,2335.4,18910,18070,840,4.64859
10,群馬県,10525,邑楽町,25537,12861,12676,26426,-889,-3.36411,101.45945,31.11,820.9,9710,9528,182,1.91016
11,埼玉県,11100,さいたま市,1324591,652965,671626,1263979,60612,4.79533,97.22152,217.43,6092,580658,533209,47449,8.89876
11,埼玉県,11101,さいたま市西区,93512,45848,47664,87146,6366,7.30498,96.19,29.12,3211.3,38361,33871,4490,13.25618
11,埼玉県,11102,さいたま市北区,149303,73404,75899,143446,5857,4.08307,96.71274,16.86,8855.5,66357,61756,4601,7.45029
11,埼玉県,11103,さいたま市大宮区,117875,58353,59522,113864,4011,3.52262,98.03602,12.8,9209,54965,53265,1700,3.19159
11,埼玉県,11104,さいたま市見沼区,165105,80738,84367,161960,3145,1.94184,95.69856,30.69,5379.8,70345,65666,4679,7.12545
11,埼玉県,11105,さいたま市中央区,103321,50998,52323,98762,4559,4.61615,97.46765,8.39,12314.8,47602,42872,4730,11.03284
11,埼玉県,11106,さいたま市桜区,98718,49771,48947,97910,808,0.82525,101.68345,18.64,5296,46197,43331,2866,6.6142
11,埼玉県,11107,さいたま市浦和区,164851,79543,85308,154416,10435,6.75772,93.24213,11.51,14322.4,74341,67136,7205,10.73195
11,埼玉県,11108,さいたま市南区,191635,95491,96144,180152,11483,6.37406,99.32081,13.82,13866.5,85589,77895,7694,9.8774
11,埼玉県,11109,さいたま市緑区,128399,63236,65163,116522,11877,10.19292,97.0428,26.44,4856.2,50757,44475,6282,14.12479
11,埼玉県,11110,さいたま市岩槻区,111872,55583,56289,109801,2071,1.88614,98.74576,49.17,2275.2,46144,42942,3202,7.45657
11,埼玉県,11201,川越市,354680,177393,177287,350745,3935,1.1219,100.05979,109.13,3250.1,153071,145715,7356,5.04821
11,埼玉県,11202,熊谷市,194439,97040,97399,198742,-4303,-2.16512,99.63141,159.82,1216.6,80030,77004,3026,3.92967
11,埼玉県,11203,川口市,594461,299265,295196,578112,16349,2.828,101.37841,61.95,9595.8,265961,245830,20131,8.18899
11,埼玉県,11206,行田市,78671,38746,39925,82113,-3442,-4.19178,97.04696,67.49,1165.7,31776,31015,761,2.45365
11,埼玉県,11207,秩父市,59706,29070,30636,63555,-3849,-6.05617,94.88837,577.83,103.3,23906,24038,-132,-0.54913
11,埼玉県,11208,所沢市,342535,168168,174367,340386,2149,0.63134,96.44485,72.11,4750.2,152555,145834,6721,4.60866
11,埼玉県,11209,飯能市,80391,40287,40104,80715,-324,-0.40141,100.45631,193.05,416.4,33452,31749,1703,5.36395
11,埼玉県,11210,加須市,111702,56003,55699,112229,-527,-0.46958,100.54579,133.3,838,44121,41034,3087,7.52303
11,埼玉県,11211,本庄市,78623,39231,39392,77881,742,0.95274,99.59129,89.69,876.6,32860,31004,1856,5.98632
11,埼玉県,11212,東松山市,91838,46186,45652,91437,401,0.43855,101.16972,65.35,1405.3,39778,37224,2554,6.86116
11,埼玉県,11214,春日部市,229767,113428,116339,232709,-2942,-1.26424,97.49783,66,3481.3,97329,94463,2866,3.03399
11,埼玉県,11215,狭山市,148712,74138,74574,152405,-3693,-2.42315,99.41535,48.99,3035.6,63553,62028,1525,2.45857
11,埼玉県,11216,羽生市,52879,26153,26726,54874,-1995,-3.6356,97.85602,58.64,901.8,21089,20366,723,3.55003
11,埼玉県,11217,鴻巣市,116864,57672,59192,118072,-1208,-1.0231,97.43209,67.44,1732.9,47316,45043,2273,5.04629
11,埼玉県,11218,深谷市,141336,70229,71107,143811,-2475,-1.72101,98.76524,138.37,1021.4,55670,53384,2286,4.28218
11,埼玉県,11219,上尾市,227020,112289,114731,225196,1824,0.80996,97.87154,45.51,4988.4,96361,91399,4962,5.42894
11,埼玉県,11221,草加市,248037,125021,123016,247034,1003,0.40602,101.62987,27.46,9032.7,111912,105827,6085,5.74995
11,埼玉県,11222,越谷市,341765,168776,172989,337498,4267,1.2643,97.56459,60.24,5673.4,142215,136460,5755,4.21735
11,埼玉県,11223,蕨市,74326,37486,36840,72260,2066,2.85912,101.75353,5.11,14545.2,36555,34174,2381,6.96729
11,埼玉県,11224,戸田市,140868,71359,69509,136150,4718,3.4653,102.66153,18.19,7744.3,64129,59432,4697,7.90315
11,埼玉県,11225,入間市,145723,71808,73915,148390,-2667,-1.79729,97.14943,44.69,3260.8,61002,59004,1998,3.38621
11,埼玉県,11227,朝霞市,141036,70663,70373,136299,4737,3.47545,100.41209,18.34,7690.1,62353,59515,2838,4.76855
11,埼玉県,11228,志木市,75377,36943,38434,72676,2701,3.7165,96.12062,9.05,8329,32677,30607,2070,6.76316
11,埼玉県,11229,和光市,83997,43142,40855,80826,3171,3.92324,105.59785,11.04,7608.4,39808,36898,2910,7.88661
11,埼玉県,11230,新座市,166104,81792,84312,162122,3982,2.45617,97.0111,22.78,7291.7,73614,67250,6364,9.4632
11,埼玉県,11231,桶川市,74778,36957,37821,73936,842,1.13882,97.71555,25.35,2949.8,30865,28685,2180,7.59979
11,埼玉県,11232,久喜市,150599,74596,76003,152311,-1712,-1.12402,98.14876,82.41,1827.4,62272,59082,3190,5.39928
11,埼玉県,11233,北本市,65228,32221,33007,67409,-2181,-3.23547,97.61869,19.82,3291,27261,26845,416,1.54964
11,埼玉県,11234,八潮市,93412,48005,45407,86717,6695,7.72052,105.72158,18.02,5183.8,42006,35763,6243,17.45659
11,埼玉県,11235,富士見市,111881,54872,57009,108102,3779,3.49577,96.25147,19.77,5659.1,50916,47169,3747,7.94378
11,埼玉県,11237,三郷市,142177,71485,70692,136521,5656,4.14295,101.12177,30.13,4718.8,60446,55288,5158,9.32933
11,埼玉県,11238,蓮田市,61530,30478,31052,62380,-850,-1.36262,98.15149,27.28,2255.5,25462,24543,919,3.74445
11,埼玉県,11239,坂戸市,100300,50039,50261,101679,-1379,-1.35623,99.55831,41.02,2445.1,44317,42883,1434,3.34398
11,埼玉県,11240,幸手市,50095,24984,25111,52524,-2429,-4.62455,99.49425,33.93,1476.4,20803,20568,235,1.14255
11,埼玉県,11241,鶴ヶ島市,70198,34607,35591,70255,-57,-0.08113,97.23526,17.65,3977.2,30485,28658,1827,6.37518
11,埼玉県,11242,日高市,54591,26946,27645,56520,-1929,-3.41295,97.47151,47.48,1149.8,22363,22145,218,0.98442
11,埼玉県,11243,吉川市,72028,35808,36220,69738,2290,3.28372,98.86251,31.66,2275,27750,25716,2034,7.90947
11,埼玉県,11245,ふじみ野市,113640,56078,57562,110970,2670,2.40606,97.42191,14.64,7762.3,49299,45806,3493,7.62564
11,埼玉県,11246,白岡市,52223,25748,26475,51535,688,1.33502,97.25401,24.92,2095.6,20397,19183,1214,6.32852
11,埼玉県,11301,伊奈町,44848,22549,22299,44442,406,0.91355,101.12113,14.79,3032.3,17765,16701,1064,6.37088
11,埼玉県,11324,三芳町,38452,18954,19498,38456,-4,-0.0104,97.20997,15.33,2508.3,15024,14328,696,4.85762
11,埼玉県,11326,毛呂山町,35379,17536,17843,37275,-1896,-5.08652,98.27944,34.07,1038.4,15695,15566,129,0.82873
11,埼玉県,11327,越生町,11042,5494,5548,11716,-674,-5.75282,99.02668,40.39,273.4,4581,4527,54,1.19284
11,埼玉県,11341,滑川町,19682,10040,9642,18212,1470,8.0716,104.12777,29.68,663.1,7563,6785,778,11.46647
11,埼玉県,11342,嵐山町,17904,8942,8962,18341,-437,-2.38264,99.77684,29.92,598.4,7413,6968,445,6.38634
11,埼玉県,11343,小川町,28536,14188,14348,31178,-2642,-8.47392,98.88486,60.36,472.8,11764,12007,-243,-2.02382
11,埼玉県,11346,川島町,19398,9832,9566,20788,-1390,-6.68655,102.78068,41.63,466,7255,7238,17,0.23487
11,埼玉県,11347,吉見町,18196,9130,9066,19631,-1435,-7.30987,100.70593,38.64,470.9,6847,6834,13,0.19023
11,埼玉県,11348,鳩山町,13581,6561,7020,14338,-757,-5.27968,93.46154,25.73,527.8,5394,5309,85,1.60105
11,埼玉県,11349,ときがわ町,10547,5334,5213,11492,-945,-8.22311,102.32112,55.9,188.7,4200,4199,1,0.02382
11,埼玉県,11361,横瀬町,7981,3965,4016,8519,-538,-6.3153,98.73008,49.36,161.7,3081,3074,7,0.22772
11,埼玉県,11362,皆野町,9305,4590,4715,10133,-828,-8.17132,97.34889,63.74,146,3573,3662,-89,-2.43037
11,埼玉県,11363,長瀞町,6809,3322,3487,7324,-515,-7.03168,95.26814,30.43,223.8,2609,2648,-39,-1.47281
11,埼玉県,11365,小鹿野町,10890,5365,5525,12117,-1227,-10.12627,97.10407,171.26,63.6,4175,4363,-188,-4.30896
11,埼玉県,11369,東秩父村,2710,1352,1358,2915,-205,-7.03259,99.55817,37.06,73.1,990,1028,-38,-3.6965
11,埼玉県,11381,美里町,11040,5539,5501,11207,-167,-1.49014,100.69078,33.41,330.4,3859,3612,247,6.83832
11,埼玉県,11383,神川町,13380,6780,6600,13730,-350,-2.54916,102.72727,47.4,282.3,5172,5033,139,2.76177
11,埼玉県,11385,上里町,30347,15011,15336,30565,-218,-0.71323,97.8808,29.18,1040,11819,11225,594,5.29176
11,埼玉県,11408,寄居町,32386,16062,16324,34081,-1695,-4.97345,98.395,64.25,504.1,13246,12934,312,2.41225
11,埼玉県,11442,宮代町,34163,17183,16980,33705,458,1.35885,101.19552,15.95,2141.9,14553,13728,825,6.00962
11,埼玉県,11464,杉戸町,43860,21933,21927,45495,-1635,-3.5938,100.02736,30.03,1460.5,17673,17348,325,1.87341
11,埼玉県,11465,松伏町,28272,14195,14077,30061,-1789,-5.95123,100.83825,16.2,1745.2,10706,10702,4,0.03738
12,千葉県,12100,千葉市,975210,481154,494056,971882,3328,0.34243,97.38856,271.78,3588.2,446695,417857,28838,6.9014
12,千葉県,12101,千葉市中央区,211734,105665,106069,205227,6507,3.17064,99.61912,44.72,4734.7,109092,95305,13787,14.46619
12,千葉県,12102,千葉市花見川区,177408,87288,90120,179200,-1792,-1,96.85752,34.19,5188.9,80741,77732,3009,3.87099
12,千葉県,12103,千葉市稲毛区,160684,80362,80322,160968,-284,-0.17643,100.0498,21.22,7572.3,74617,71334,3283,4.60229
12,千葉県,12104,千葉市若葉区,146976,72965,74011,150921,-3945,-2.61395,98.5867,84.19,1745.8,64627,62695,1932,3.08159
12,千葉県,12105,千葉市緑区,129467,63118,66349,126848,2619,2.06468,95.1303,66.25,1954.2,50816,46792,4024,8.59976
12,千葉県,12106,千葉市美浜区,148941,71756,77185,148718,223,0.14995,92.96625,21.2,7025.5,66802,63999,2803,4.37976
12,千葉県,12202,銚子市,58478,28249,30229,64415,-5937,-9.2168,93.45,84.2,694.5,25515,26234,-719,-2.74072
12,千葉県,12203,市川市,496943,251388,245555,481732,15211,3.15756,102.37544,57.45,8650,242251,228845,13406,5.85811
12,千葉県,12204,船橋市,642972,318847,324125,622890,20082,3.224,98.37162,85.62,7509.6,289027,272432,16595,6.09143
12,千葉県,12205,館山市,45177,21850,23327,47464,-2287,-4.81839,93.66828,110.05,410.5,20225,20146,79,0.39214
12,千葉県,12206,木更津市,136224,68464,67760,134141,2083,1.55284,101.03896,138.95,980.4,58178,54920,3258,5.93227
12,千葉県,12207,松戸市,498293,247044,251249,483480,14813,3.06383,98.32636,61.38,8118.2,230650,215627,15023,6.96712
12,千葉県,12208,野田市,152674,76171,76503,153583,-909,-0.59186,99.56603,103.55,1474.4,63578,59712,3866,6.47441
12,千葉県,12210,茂原市,86821,42656,44165,89688,-2867,-3.19664,96.58327,99.92,868.9,37049,36026,1023,2.83962
12,千葉県,12211,成田市,132998,66249,66749,131190,1808,1.37815,99.25093,213.84,622,59985,55462,4523,8.15513
12,千葉県,12212,佐倉市,168858,82450,86408,172739,-3881,-2.24674,95.41941,103.69,1628.5,70244,68696,1548,2.25341
12,千葉県,12213,東金市,58248,29255,28993,60652,-2404,-3.9636,100.90367,89.12,653.6,25353,25114,239,0.95166
12,千葉県,12215,旭市,63788,31396,32392,66586,-2798,-4.20208,96.92517,130.45,489,24172,23350,822,3.52034
12,千葉県,12216,習志野市,176306,87890,88416,167909,8397,5.00092,99.40509,20.97,8407.5,79184,72350,6834,9.44575
12,千葉県,12217,柏市,426552,210721,215831,413954,12598,3.04333,97.63241,114.74,3717.6,188045,175691,12354,7.03166
12,千葉県,12218,勝浦市,16938,8705,8233,19248,-2310,-12.00125,105.73303,93.96,180.3,8197,8965,-768,-8.56665
12,千葉県,12219,市原市,269653,138466,131187,274656,-5003,-1.82155,105.54857,368.17,732.4,117675,113518,4157,3.66197
12,千葉県,12220,流山市,199960,98446,101514,174373,25587,14.67372,96.97776,35.32,5661.4,82961,70802,12159,17.17324
12,千葉県,12221,八千代市,199597,97916,101681,193152,6445,3.33675,96.29724,51.39,3884,84857,78358,6499,8.29398
12,千葉県,12222,我孫子市,130590,63562,67028,131606,-1016,-0.772,94.82903,43.15,3026.4,56265,54089,2176,4.023
12,千葉県,12223,鴨川市,32149,15230,16919,33932,-1783,-5.25463,90.01714,191.14,168.2,14583,14453,130,0.89947
12,千葉県,12224,鎌ケ谷市,109989,53592,56397,108917,1072,0.98424,95.02633,21.08,5217.7,47021,44101,2920,6.62117
12,千葉県,12225,君津市,82249,41933,40316,86033,-3784,-4.39831,104.01081,318.81,258,35352,34447,905,2.62722
12,千葉県,12226,富津市,42508,21538,20970,45601,-3093,-6.78275,102.70863,205.5,206.9,17818,17634,184,1.04344
12,千葉県,12227,浦安市,171424,83500,87924,164024,7400,4.51153,94.96838,17.3,9908.9,79934,74229,5705,7.68568
12,千葉県,12228,四街道市,93632,46355,47277,89245,4387,4.91568,98.04979,34.52,2712.4,38301,35014,3287,9.38767
12,千葉県,12229,袖ケ浦市,63906,32211,31695,60952,2954,4.84644,101.62802,94.93,673.2,25370,22652,2718,11.99894
12,千葉県,12230,八街市,67480,34121,33359,70734,-3254,-4.60033,102.28424,74.94,900.5,27683,27074,609,2.24939
12,千葉県,12231,印西市,102651,50569,52082,92670,9981,10.77048,97.09497,123.79,829.2,38200,32590,5610,17.21387
12,千葉県,12232,白井市,62470,30927,31543,61674,796,1.29066,98.04711,35.48,1760.7,24071,22725,1346,5.92299
12,千葉県,12233,富里市,49762,25307,24455,49636,126,0.25385,103.48395,53.88,923.6,21713,20057,1656,8.25647
12,千葉県,12234,南房総市,35844,17009,18835,39033,-3189,-8.17001,90.30528,230.12,155.8,14720,15061,-341,-2.26413
12,千葉県,12235,匝瑳市,35099,17264,17835,37261,-2162,-5.80231,96.79843,101.52,345.7,12853,12712,141,1.10919
12,千葉県,12236,香取市,72427,35630,36797,77499,-5072,-6.5446,96.82855,262.35,276.1,27528,27294,234,0.85733
12,千葉県,12237,山武市,48462,24195,24267,52222,-3760,-7.20003,99.7033,146.77,330.2,19330,19454,-124,-0.6374
12,千葉県,12238,いすみ市,35571,17374,18197,38594,-3023,-7.83282,95.47728,157.5,225.8,14580,14849,-269,-1.81157
12,千葉県,12239,大網白里市,48155,23552,24603,49184,-1029,-2.09214,95.72816,58.08,829.1,19531,18849,682,3.61823
12,千葉県,12322,酒々井町,20760,10160,10600,20955,-195,-0.93057,95.84906,19.01,1092.1,9388,8970,418,4.65998
12,千葉県,12329,栄町,20140,9868,10272,21228,-1088,-5.12531,96.06698,32.51,619.5,8245,8185,60,0.73305
12,千葉県,12342,神崎町,5820,2938,2882,6133,-313,-5.10354,101.9431,19.9,292.5,2287,2207,80,3.62483
12,千葉県,12347,多古町,13748,6942,6806,14724,-976,-6.62863,101.99824,72.8,188.8,5039,5053,-14,-0.27706
12,千葉県,12349,東庄町,13235,6578,6657,14152,-917,-6.47965,98.81328,46.25,286.2,4579,4562,17,0.37264
12,千葉県,12403,九十九里町,14644,7203,7441,16510,-1866,-11.30224,96.80151,24.46,598.7,6143,6411,-268,-4.18032
12,千葉県,12409,芝山町,7042,3478,3564,7431,-389,-5.23483,97.58698,43.24,162.9,2501,2453,48,1.95679
12,千葉県,12410,横芝光町,22091,10771,11320,23762,-1671,-7.03224,95.15018,67.01,329.7,8238,8433,-195,-2.31234
12,千葉県,12421,一宮町,11900,5827,6073,11767,133,1.13028,95.94928,22.99,517.6,4972,4485,487,10.85842
12,千葉県,12422,睦沢町,6768,3259,3509,7222,-454,-6.28635,92.87546,35.59,190.2,2452,2434,18,0.73952
12,千葉県,12423,長生村,13808,6800,7008,14359,-551,-3.83731,97.03196,28.25,488.8,5596,5178,418,8.07261
12,千葉県,12424,白子町,10311,5115,5196,11149,-838,-7.51637,98.44111,27.5,374.9,4130,4164,-34,-0.81652
12,千葉県,12426,長柄町,6725,3291,3434,7337,-612,-8.34128,95.83576,47.11,142.8,2495,2591,-96,-3.70513
12,千葉県,12427,長南町,7205,3529,3676,8206,-1001,-12.19839,96.00109,65.51,110,2635,2789,-154,-5.52169
12,千葉県,12441,大多喜町,8899,4312,4587,9843,-944,-9.59057,94.0048,129.87,68.5,3373,3447,-74,-2.14679
12,千葉県,12443,御宿町,6882,3258,3624,7315,-433,-5.91934,89.90066,24.85,276.9,3199,3054,145,4.74787
12,千葉県,12463,鋸南町,6998,3356,3642,8022,-1024,-12.7649,92.14717,45.19,154.9,3033,3327,-294,-8.83679
13,東京都,13000,東京都,14064696,6902188,7162508,13515272,549424,4.06521,96.36552,2194.03,6410.4,7219402,6701123,518279,7.73421
13,東京都,13100,特別区部,9744534,4776168,4968366,9272740,471794,5.08797,96.13157,627.53,15528.4,5209997,4801194,408803,8.51461
13,東京都,13101,千代田区,66758,33686,33072,58406,8352,14.2999,101.85656,11.66,5725.4,37396,33262,4134,12.4286
13,東京都,13102,中央区,169318,80969,88349,141183,28135,19.92804,91.64676,10.21,16583.5,92338,79272,13066,16.48249
13,東京都,13103,港区,260851,123542,137309,243283,17568,7.22122,89.97371,20.37,12805.6,146114,130562,15552,11.91158
13,東京都,13104,新宿区,349743,174810,174933,333560,16183,4.8516,99.92969,18.22,19195.6,222820,204989,17831,8.69852
13,東京都,13105,文京区,240297,115547,124750,219724,20573,9.36311,92.62285,11.29,21284.1,133271,120858,12413,10.27073
13,東京都,13106,台東区,211779,108617,103162,198073,13706,6.91967,105.2878,10.11,20947.5,124231,112117,12114,10.80478
13,東京都,13107,墨田区,272190,134775,137415,256274,15916,6.21054,98.07881,13.77,19766.9,145682,130862,14820,11.32491
13,東京都,13108,江東区,524547,258009,266538,498109,26438,5.30767,96.80008,42.99,12201.6,264307,243708,20599,8.45233
13,東京都,13109,品川区,422795,208753,214042,386855,35940,9.2903,97.52899,22.84,18511.2,237399,212374,25025,11.78346
13,東京都,13110,目黒区,288501,135930,152571,277622,10879,3.91864,89.09295,14.67,19666.1,155320,146162,9158,6.26565
13,東京都,13111,大田区,748291,372452,375839,717082,31209,4.35222,99.09882,61.86,12096.5,399477,371149,28328,7.63251
13,東京都,13112,世田谷区,948147,447114,501033,903346,44801,4.95945,89.23843,58.05,16333.3,494092,463632,30460,6.56987
13,東京都,13113,渋谷区,244067,117893,126174,224533,19534,8.69983,93.43684,15.11,16152.7,149012,135749,13263,9.77024
13,東京都,13114,中野区,345089,172361,172728,328215,16874,5.14114,99.78753,15.59,22135.3,207005,196132,10873,5.54372
13,東京都,13115,杉並区,592241,284781,307460,563997,28244,5.00783,92.62376,34.06,17388.2,336954,312001,24953,7.99773
13,東京都,13116,豊島区,302098,151047,151051,291167,10931,3.7542,99.99735,13.01,23220.4,183801,176376,7425,4.20976
13,東京都,13117,北区,355501,176122,179379,341076,14425,4.22926,98.18429,20.61,17249,188380,178379,10001,5.6066
13,東京都,13118,荒川区,217713,107726,109987,212264,5449,2.56709,97.9443,10.16,21428.4,111894,103101,8793,8.52853
13,東京都,13119,板橋区,584403,285903,298500,561916,22487,4.00184,95.7799,32.22,18137.9,314356,291408,22948,7.87487
13,東京都,13120,練馬区,753045,361682,391363,721722,31323,4.34004,92.41599,48.08,15662.3,373946,337987,35959,10.63917
13,東京都,13121,足立区,695530,347413,348117,670122,25408,3.79155,99.79777,53.25,13061.6,344645,310662,33983,10.9389
13,東京都,13122,葛飾区,453441,225849,227592,442913,10528,2.37699,99.23416,34.8,13029.9,215521,201380,14141,7.02205
13,東京都,13123,江戸川区,698189,351187,347002,681298,16891,2.47924,101.20604,49.9,13991.8,332036,309072,22964,7.42998
13,東京都,13201,八王子市,579605,291381,288224,577513,2092,0.36224,101.09533,186.38,3109.8,265572,253356,12216,4.82167
13,東京都,13202,立川市,187089,92702,94387,176295,10794,6.12269,98.2148,24.36,7680.2,92301,83285,9016,10.82548
13,東京都,13203,武蔵野市,150102,71837,78265,144730,5372,3.71174,91.78688,10.98,13670.5,78022,74022,4000,5.4038
13,東京都,13204,三鷹市,195558,94550,101008,186936,8622,4.61227,93.60645,16.42,11909.7,96377,90226,6151,6.81733
13,東京都,13205,青梅市,133587,66631,66956,137381,-3794,-2.76166,99.51461,103.31,1293.1,56570,54371,2199,4.04444
13,東京都,13206,府中市,262932,131474,131458,260274,2658,1.02123,100.01217,29.43,8934.1,124317,119569,4748,3.97093
13,東京都,13207,昭島市,114053,56658,57395,111539,2514,2.25392,98.71592,17.34,6577.5,52420,48258,4162,8.62448
13,東京都,13208,調布市,242721,117046,125675,229061,13660,5.96348,93.13388,21.58,11247.5,120429,110581,9848,8.90569
13,東京都,13209,町田市,431525,210812,220713,432349,-824,-0.19059,95.51408,71.55,6031.1,191959,186712,5247,2.81021
13,東京都,13210,小金井市,126253,61799,64454,121396,4857,4.00096,95.88078,11.3,11172.8,63323,59796,3527,5.89839
13,東京都,13211,小平市,198977,97492,101485,190005,8972,4.72198,96.06543,20.51,9701.5,90237,82888,7349,8.86618
13,東京都,13212,日野市,190261,94809,95452,186283,3978,2.13546,99.32636,27.55,6906,90270,84928,5342,6.29003
13,東京都,13213,東村山市,151941,73820,78121,149956,1985,1.32372,94.49444,17.14,8864.7,68281,64604,3677,5.6916
13,東京都,13214,国分寺市,129353,63005,66348,122742,6611,5.38609,94.96142,11.46,11287.3,63912,59130,4782,8.08727
13,東京都,13215,国立市,77167,37510,39657,73655,3512,4.76818,94.58608,8.15,9468.3,38166,34062,4104,12.04862
13,東京都,13218,福生市,56443,28030,28413,58395,-1952,-3.34275,98.65203,10.16,5555.4,28190,27260,930,3.41159
13,東京都,13219,狛江市,84807,41033,43774,80249,4558,5.67982,93.73829,6.39,13271.8,42493,39458,3035,7.69172
13,東京都,13220,東大和市,83952,41037,42915,85157,-1205,-1.41503,95.62391,13.42,6255.7,36392,35555,837,2.3541
13,東京都,13221,清瀬市,76258,36537,39721,74864,1394,1.86204,91.98409,10.23,7454.3,34964,32369,2595,8.01693
13,東京都,13222,東久留米市,115227,55558,59669,116632,-1405,-1.20464,93.11033,12.88,8946.2,51229,49902,1327,2.65921
13,東京都,13223,武蔵村山市,70863,35262,35601,71229,-366,-0.51384,99.04778,15.32,4625.5,29952,28300,1652,5.83746
13,東京都,13224,多摩市,147169,71739,75430,146631,538,0.36691,95.10672,21.01,7004.7,68444,65461,2983,4.55691
13,東京都,13225,稲城市,93171,46882,46289,87636,5535,6.3159,101.28108,17.97,5184.8,39812,36533,3279,8.97545
13,東京都,13227,羽村市,54341,27479,26862,55833,-1492,-2.67225,102.29693,9.9,5489,23784,23451,333,1.41998
13,東京都,13228,あきる野市,79366,39286,40080,80954,-1588,-1.96161,98.01896,73.47,1080.3,31791,30817,974,3.16059
13,東京都,13229,西東京市,207389,100969,106420,200012,7377,3.68828,94.87784,15.75,13167.6,95629,89734,5895,6.56942
13,東京都,13303,瑞穂町,31774,15998,15776,33445,-1671,-4.99626,101.4072,16.85,1885.7,12942,13192,-250,-1.89509
13,東京都,13305,日の出町,17048,8394,8654,17446,-398,-2.28133,96.99561,28.07,607.3,6008,5800,208,3.58621
13,東京都,13307,檜原村,2003,983,1020,2209,-206,-9.32549,96.37255,105.41,19,841,839,2,0.23838
13,東京都,13308,奥多摩町,4752,2389,2363,5234,-482,-9.20902,101.1003,225.53,21.1,1984,2045,-61,-2.98289
13,東京都,13361,大島町,7104,3665,3439,7884,-780,-9.89346,106.57168,90.76,78.3,3716,3947,-231,-5.85255
13,東京都,13362,利島村,327,197,130,337,-10,-2.96736,151.53846,4.12,79.4,193,194,-1,-0.51546
13,東京都,13363,新島村,2441,1204,1237,2749,-308,-11.20407,97.33226,27.54,88.6,1158,1261,-103,-8.16812
13,東京都,13364,神津島村,1857,953,904,1891,-34,-1.79799,105.42035,18.58,99.9,810,791,19,2.40202
13,東京都,13381,三宅村,2274,1271,1003,2482,-208,-8.38034,126.71984,55.26,41.2,1377,1483,-106,-7.14767
13,東京都,13382,御蔵島村,323,181,142,335,-12,-3.58209,127.46479,20.54,15.7,187,194,-7,-3.60825
13,東京都,13401,八丈町,7048,3539,3509,7613,-565,-7.42152,100.85494,72.23,97.6,3766,3913,-147,-3.75671
13,東京都,13402,青ヶ島村,169,102,67,178,-9,-5.05618,152.23881,5.96,28.4,118,125,-7,-5.6
13,東京都,13421,小笠原村,2932,1806,1126,3022,-90,-2.97816,160.39076,106.88,27.4,1469,1517,-48,-3.16414
14,神奈川県,14100,横浜市,3778318,1865940,1912378,3724844,53474,1.4356,97.57171,437.71,8632,1753389,1645618,107771,6.54897
14,神奈川県,14101,横浜市鶴見区,297555,153284,144271,285356,12199,4.27501,106.24727,33.23,8954.4,145495,132814,12681,9.54794
14,神奈川県,14102,横浜市神奈川区,247322,125792,121530,238966,8356,3.49673,103.50695,23.72,10426.7,129425,119397,10028,8.39887
14,神奈川県,14103,横浜市西区,104917,53072,51845,98532,6385,6.48013,102.36667,7.03,14924.2,56804,51878,4926,9.49535
14,神奈川県,14104,横浜市中区,151388,77100,74288,148312,3076,2.07401,103.78527,21.44,7061,85405,78869,6536,8.28716
14,神奈川県,14105,横浜市南区,198054,98747,99307,194827,3227,1.65634,99.43609,12.65,15656.4,103697,95528,8169,8.55142
14,神奈川県,14106,横浜市保土ケ谷区,207816,101812,106004,205493,2323,1.13045,96.04543,21.93,9476.3,99159,92775,6384,6.88116
14,神奈川県,14107,横浜市磯子区,166795,82038,84757,166229,566,0.34049,96.79201,19.05,8755.6,78879,74552,4327,5.804
14,神奈川県,14108,横浜市金沢区,199033,96963,102070,202229,-3196,-1.58039,94.99657,30.96,6428.7,89842,86891,2951,3.39621
14,神奈川県,14109,横浜市港北区,358678,179055,179623,344172,14506,4.21475,99.68378,31.4,11422.9,175313,163519,11794,7.21262
14,神奈川県,14110,横浜市戸塚区,283908,138250,145658,275283,8625,3.13314,94.91411,35.79,7932.6,122001,113421,8580,7.56474
14,神奈川県,14111,横浜市港南区,215196,104971,110225,215736,-540,-0.25031,95.23339,19.9,10813.9,95469,91007,4462,4.90292
14,神奈川県,14112,横浜市旭区,245272,118182,127090,247144,-1872,-0.75745,92.99079,32.73,7493.8,107125,102728,4397,4.28024
14,神奈川県,14113,横浜市緑区,183147,90112,93035,180366,2781,1.54186,96.85817,25.51,7179.4,79247,74498,4749,6.37467
14,神奈川県,14114,横浜市瀬谷区,122671,59336,63335,124560,-1889,-1.51654,93.68596,17.17,7144.5,52338,50435,1903,3.77317
14,神奈川県,14115,横浜市栄区,120263,58545,61718,122171,-1908,-1.56175,94.85887,18.52,6493.7,52651,50853,1798,3.53568
14,神奈川県,14116,横浜市泉区,152452,73907,78545,154025,-1573,-1.02126,94.0951,23.58,6465.3,62853,60707,2146,3.53501
14,神奈川県,14117,横浜市青葉区,310699,150208,160491,309692,1007,0.32516,93.59279,35.22,8821.7,133422,125344,8078,6.44466
14,神奈川県,14118,横浜市都筑区,213152,104566,108586,211751,1401,0.66163,96.29787,27.87,7648.1,84264,80402,3862,4.80336
14,神奈川県,14130,川崎市,1539081,775849,763232,1475213,63868,4.32941,101.6531,143.01,10762.1,746866,691837,55029,7.95404
14,神奈川県,14131,川崎市川崎区,233228,125182,108046,223378,9850,4.40957,115.85991,39.53,5900,123599,109768,13831,12.60021
14,神奈川県,14132,川崎市幸区,171188,86703,84485,160890,10298,6.40065,102.62532,10.01,17101.7,79953,75160,4793,6.37706
14,神奈川県,14133,川崎市中原区,263785,133902,129883,247529,16256,6.56731,103.09432,14.74,17895.9,134751,123547,11204,9.06861
14,神奈川県,14134,川崎市高津区,234342,116321,118021,228141,6201,2.71806,98.55958,16.36,14324.1,113652,107931,5721,5.30061
14,神奈川県,14135,川崎市多摩区,221853,112909,108944,214158,7695,3.59314,103.63948,20.5,10822.1,113324,106472,6852,6.43549
14,神奈川県,14136,川崎市宮前区,233796,113359,120437,225594,8202,3.63573,94.12307,18.61,12562.9,102235,94808,7427,7.83373
14,神奈川県,14137,川崎市麻生区,180889,87473,93416,175523,5366,3.05715,93.63813,23.25,7780.2,79352,74151,5201,7.01407
14,神奈川県,14150,相模原市,725302,361815,363487,720779,4523,0.62752,99.54001,328.91,2205.2,332069,311187,20882,6.71043
14,神奈川県,14151,相模原市緑区,170139,85514,84625,173612,-3473,-2.00044,101.05052,253.93,670,74829,71182,3647,5.12349
14,神奈川県,14152,相模原市中央区,273651,136956,136695,269887,3764,1.39466,100.19094,36.87,7422.1,124629,116239,8390,7.21789
14,神奈川県,14153,相模原市南区,281512,139345,142167,277280,4232,1.52626,98.01501,38.11,7386.8,132611,123766,8845,7.14655
14,神奈川県,14201,横須賀市,388504,193794,194710,406586,-18082,-4.44728,99.52956,100.82,3853.4,165031,165746,-715,-0.43138
14,神奈川県,14203,平塚市,258524,129050,129474,258227,297,0.11502,99.67252,67.82,3811.9,111823,107397,4426,4.12116
14,神奈川県,14204,鎌倉市,172821,81062,91759,173019,-198,-0.11444,88.34229,39.67,4356.5,75724,73035,2689,3.6818
14,神奈川県,14205,藤沢市,437155,215672,221483,423894,13261,3.12838,97.37632,69.56,6284.6,193054,180170,12884,7.15102
14,神奈川県,14206,小田原市,188986,91347,97639,194086,-5100,-2.6277,93.55585,113.6,1663.6,81669,79120,2549,3.22169
14,神奈川県,14207,茅ヶ崎市,242603,117669,124934,239348,3255,1.35994,94.18493,35.7,6795.6,102458,97951,4507,4.60128
14,神奈川県,14208,逗子市,56981,26706,30275,57425,-444,-0.77318,88.2114,17.28,3297.5,24879,24103,776,3.21952
14,神奈川県,14210,三浦市,42098,20152,21946,45289,-3191,-7.04586,91.82539,32.05,1313.5,17205,17567,-362,-2.06068
14,神奈川県,14211,秦野市,162579,82347,80232,167378,-4799,-2.86716,102.63611,103.76,1566.9,70381,69778,603,0.86417
14,神奈川県,14212,厚木市,223747,115319,108428,225714,-1967,-0.87146,106.35537,93.84,2384.3,100073,95824,4249,4.43417
14,神奈川県,14213,大和市,239269,119592,119677,232922,6347,2.72495,99.92898,27.09,8832.4,110276,102020,8256,8.09253
14,神奈川県,14214,伊勢原市,101839,51481,50358,101514,325,0.32015,102.23003,55.56,1833,45231,43088,2143,4.97354
14,神奈川県,14215,海老名市,136581,68628,67953,130190,6391,4.90898,100.99333,26.59,5136.6,58226,53416,4810,9.00479
14,神奈川県,14216,座間市,132180,65842,66338,128737,3443,2.67444,99.25231,17.57,7523.1,60106,55910,4196,7.50492
14,神奈川県,14217,南足柄市,40859,20013,20846,43306,-2447,-5.65049,96.00403,77.12,529.8,16282,16245,37,0.22776
14,神奈川県,14218,綾瀬市,83964,42597,41367,84460,-496,-0.58726,102.97338,22.14,3792.4,34811,33356,1455,4.36203
14,神奈川県,14301,葉山町,31627,14891,16736,32096,-469,-1.46124,88.97586,17.04,1856,12942,12580,362,2.87758
14,神奈川県,14321,寒川町,48366,24468,23898,47936,430,0.89703,102.38514,13.34,3625.6,19831,18744,1087,5.79919
14,神奈川県,14341,大磯町,31673,15420,16253,31550,123,0.38986,94.87479,17.18,1843.6,12710,12279,431,3.51006
14,神奈川県,14342,二宮町,27578,13300,14278,28378,-800,-2.81909,93.1503,9.08,3037.2,11552,11183,369,3.29965
14,神奈川県,14361,中井町,9299,4662,4637,9679,-380,-3.92603,100.53914,19.99,465.2,3426,3359,67,1.99464
14,神奈川県,14362,大井町,17138,8438,8700,17033,105,0.61645,96.98851,14.38,1191.8,6674,6178,496,8.02849
14,神奈川県,14363,松田町,10840,5406,5434,11171,-331,-2.96303,99.48473,37.75,287.2,4569,4406,163,3.6995
14,神奈川県,14364,山北町,9773,4825,4948,10724,-951,-8.86796,97.51415,224.61,43.5,3923,3903,20,0.51243
14,神奈川県,14366,開成町,18333,8911,9422,17013,1320,7.75877,94.57652,6.55,2798.9,6932,6169,763,12.36829
14,神奈川県,14382,箱根町,11303,5425,5878,11786,-483,-4.09808,92.2933,92.86,121.7,6349,6088,261,4.28712
14,神奈川県,14383,真鶴町,6725,3124,3601,7333,-608,-8.29129,86.75368,7.05,953.9,2962,3068,-106,-3.45502
14,神奈川県,14384,湯河原町,23433,10870,12563,25026,-1593,-6.36538,86.52392,40.97,572,10708,10763,-55,-0.51101
14,神奈川県,14401,愛川町,39894,20888,19006,40343,-449,-1.11296,109.90214,34.28,1163.8,16976,16067,909,5.65756
14,神奈川県,14402,清川村,3038,1556,1482,3214,-176,-5.47604,104.99325,71.24,42.6,1126,1122,4,0.35651
15,新潟県,15100,新潟市,789715,379788,409927,810157,-20442,-2.52321,92.64772,726.27,1087.4,331076,321511,9565,2.97501
15,新潟県,15101,新潟市北区,72847,35493,37354,76328,-3481,-4.56058,95.01794,107.61,677,27413,27070,343,1.26709
15,新潟県,15102,新潟市東区,134527,64397,70130,137577,-3050,-2.21694,91.82518,38.62,3483.4,57449,55550,1899,3.41854
15,新潟県,15103,新潟市中央区,180432,86053,94379,183767,-3335,-1.8148,91.17812,37.75,4779.7,90818,88506,2312,2.61225
15,新潟県,15104,新潟市江南区,68001,32933,35068,68906,-905,-1.31338,93.91183,75.42,901.6,24842,23677,1165,4.92039
15,新潟県,15105,新潟市秋葉区,75094,36022,39072,76843,-1749,-2.27607,92.1939,95.38,787.3,27967,26898,1069,3.97427
15,新潟県,15106,新潟市南区,43483,20983,22500,45685,-2202,-4.81996,93.25778,100.91,430.9,14931,14583,348,2.38634
15,新潟県,15107,新潟市西区,160742,77673,83069,162833,-2091,-1.28414,93.5042,94,1710,68954,66860,2094,3.13192
15,新潟県,15108,新潟市西蒲区,54589,26234,28355,58218,-3629,-6.23347,92.51984,176.57,309.2,18702,18367,335,1.82392
15,新潟県,15202,長岡市,267115,131054,136061,275133,-8018,-2.91423,96.32003,891.06,299.8,104505,100143,4362,4.35577
15,新潟県,15204,三条市,94679,45829,48850,99192,-4513,-4.54976,93.81576,431.97,219.2,33969,33201,768,2.31318
15,新潟県,15205,柏崎市,81549,40552,40997,86833,-5284,-6.08524,98.91455,442.03,184.5,33820,33560,260,0.77473
15,新潟県,15206,新発田市,94976,45965,49011,98611,-3635,-3.6862,93.78507,533.11,178.2,35179,34186,993,2.9047
15,新潟県,15208,小千谷市,34102,16886,17216,36498,-2396,-6.56474,98.08318,155.19,219.7,12109,12165,-56,-0.46034
15,新潟県,15209,加茂市,25449,12414,13035,27852,-2403,-8.62775,95.2359,133.72,190.3,9392,9634,-242,-2.51194
15,新潟県,15210,十日町市,49834,24343,25491,54917,-5083,-9.25579,95.49645,590.39,84.4,18008,18598,-590,-3.17238
15,新潟県,15211,見附市,39252,19063,20189,40608,-1356,-3.33924,94.42271,77.91,503.8,14102,13702,400,2.91928
15,新潟県,15212,村上市,57444,27476,29968,62442,-4998,-8.00423,91.68446,1174.17,48.9,21588,22138,-550,-2.48442
15,新潟県,15213,燕市,77234,37622,39612,79784,-2550,-3.19613,94.97627,110.94,696.2,28535,27537,998,3.62421
15,新潟県,15216,糸魚川市,40778,20072,20706,44162,-3384,-7.6627,96.93809,746.24,54.6,16459,16699,-240,-1.43721
15,新潟県,15217,妙高市,30402,14744,15658,33199,-2797,-8.42495,94.16273,445.63,68.2,11341,11562,-221,-1.91143
15,新潟県,15218,五泉市,47650,22878,24772,51404,-3754,-7.30293,92.35427,351.91,135.4,17016,16945,71,0.419
15,新潟県,15222,上越市,188119,91921,96198,196987,-8868,-4.50182,95.55396,973.89,193.2,72804,71015,1789,2.51919
15,新潟県,15223,阿賀野市,40708,19568,21140,43415,-2707,-6.23517,92.56386,192.74,211.2,13483,13390,93,0.69455
15,新潟県,15224,佐渡市,51513,24882,26631,57255,-5742,-10.02882,93.43247,855.68,60.2,21268,22401,-1133,-5.05781
15,新潟県,15225,魚沼市,34501,16807,17694,37352,-2851,-7.63279,94.987,946.76,36.4,12705,12833,-128,-0.99743
15,新潟県,15226,南魚沼市,54876,26779,28097,58568,-3692,-6.30378,95.30911,584.55,93.9,19530,19426,104,0.53536
15,新潟県,15227,胎内市,28527,13955,14572,30198,-1671,-5.53348,95.76585,264.89,107.7,10294,10056,238,2.36675
15,新潟県,15307,聖籠町,14266,7173,7093,14040,226,1.60969,101.12787,37.58,379.6,4797,4262,535,12.55279
15,新潟県,15342,弥彦村,7708,3732,3976,8209,-501,-6.10306,93.86318,25.17,306.2,2608,2584,24,0.92879
15,新潟県,15361,田上町,11231,5394,5837,12188,-957,-7.85199,92.41048,31.71,354.2,3990,4028,-38,-0.9434
15,新潟県,15385,阿賀町,9970,4824,5146,11680,-1710,-14.64041,93.74271,952.89,10.5,4061,4482,-421,-9.39313
15,新潟県,15405,出雲崎町,4114,1978,2136,4528,-414,-9.14311,92.603,44.38,92.7,1535,1608,-73,-4.5398
15,新潟県,15461,湯沢町,7770,3948,3822,8046,-276,-3.43028,103.2967,357.29,21.7,3591,3455,136,3.93632
15,新潟県,15482,津南町,8992,4322,4670,10029,-1037,-10.34001,92.54818,170.21,52.8,3116,3328,-212,-6.37019
15,新潟県,15504,刈羽村,4384,2246,2138,4775,-391,-8.18848,105.05145,26.27,166.9,1570,1682,-112,-6.65874
15,新潟県,15581,関川村,5147,2444,2703,5832,-685,-11.74554,90.41805,299.61,17.2,1756,1846,-90,-4.87541
15,新潟県,15586,粟島浦村,353,181,172,370,-17,-4.59459,105.23256,9.78,36.1,168,173,-5,-2.89017
16,富山県,16201,富山市,414171,202364,211807,418686,-4515,-1.07837,95.5417,1241.74,333.5,171728,163862,7866,4.80038
16,富山県,16202,高岡市,166513,80498,86015,172125,-5612,-3.26042,93.586,209.57,794.5,65484,63814,1670,2.61698
16,富山県,16204,魚津市,40585,19733,20852,42935,-2350,-5.47339,94.63361,200.61,202.3,15793,15855,-62,-0.39104
16,富山県,16205,氷見市,43995,20896,23099,47992,-3997,-8.32847,90.46279,230.54,190.8,15765,16096,-331,-2.05641
16,富山県,16206,滑川市,32379,15749,16630,32755,-376,-1.14792,94.70235,54.62,592.8,12075,11699,376,3.21395
16,富山県,16207,黒部市,39647,19506,20141,40991,-1344,-3.27877,96.84723,426.31,93,15223,14793,430,2.90678
16,富山県,16208,砺波市,48191,23424,24767,49000,-809,-1.65102,94.57746,127.03,379.4,17106,16220,886,5.46239
16,富山県,16209,小矢部市,29018,14001,15017,30399,-1381,-4.54291,93.23433,134.07,216.4,9683,9517,166,1.74425
16,富山県,16210,南砺市,47976,22955,25021,51327,-3351,-6.52873,91.74294,668.64,71.8,16482,16594,-112,-0.67494
16,富山県,16211,射水市,90807,44272,46535,92308,-1501,-1.62608,95.13699,109.44,829.7,33820,32115,1705,5.30905
16,富山県,16321,舟橋村,3133,1522,1611,2982,151,5.06372,94.47548,3.47,902.9,1051,910,141,15.49451
16,富山県,16322,上市町,19367,9254,10113,20930,-1563,-7.46775,91.50598,236.71,81.8,7248,7395,-147,-1.98783
16,富山県,16323,立山町,24862,12049,12813,26317,-1455,-5.52875,94.03731,307.29,80.9,9043,9159,-116,-1.26651
16,富山県,16342,入善町,23875,11387,12488,25335,-1460,-5.76278,91.18354,71.25,335.1,8684,8628,56,0.64905
16,富山県,16343,朝日町,11093,5235,5858,12246,-1153,-9.41532,89.36497,226.3,49,4353,4514,-161,-3.56668
17,石川県,17201,金沢市,463583,224594,238989,465699,-2116,-0.45437,93.97671,468.79,988.9,206904,199572,7332,3.67386
17,石川県,17202,七尾市,50336,23971,26365,55325,-4989,-9.01762,90.91978,318.29,158.1,20324,20855,-531,-2.54615
17,石川県,17203,小松市,106292,52209,54083,106919,-627,-0.58643,96.53496,371.05,286.5,41180,38166,3014,7.89708
17,石川県,17204,輪島市,24633,11717,12916,27216,-2583,-9.49074,90.71694,426.32,57.8,10206,10649,-443,-4.16002
17,石川県,17205,珠洲市,12934,5936,6998,14625,-1691,-11.56239,84.82424,247.2,52.3,5493,5861,-368,-6.27879
17,石川県,17206,加賀市,63263,29952,33311,67186,-3923,-5.83901,89.91624,305.87,206.8,25237,24841,396,1.59414
17,石川県,17207,羽咋市,20429,9671,10758,21729,-1300,-5.98279,89.89589,81.85,249.6,8035,8066,-31,-0.38433
17,石川県,17209,かほく市,34911,16881,18030,34219,692,2.02227,93.62729,64.44,541.8,12528,11604,924,7.96277
17,石川県,17210,白山市,110497,53696,56801,109287,1210,1.10718,94.53355,754.93,146.4,40858,38439,2419,6.29309
17,石川県,17211,能美市,48547,24127,24420,48881,-334,-0.68329,98.80016,84.14,577,18170,17352,818,4.71415
17,石川県,17212,野々市市,57260,29557,27703,55099,2161,3.92203,106.69242,13.56,4222.7,26143,24759,1384,5.58989
17,石川県,17324,川北町,6143,3027,3116,6347,-204,-3.21412,97.14377,14.64,419.6,1909,1853,56,3.02213
17,石川県,17361,津幡町,36966,18046,18920,36968,-2,-0.00541,95.38055,110.59,334.3,13414,12545,869,6.92706
17,石川県,17365,内灘町,26588,12778,13810,26987,-399,-1.47849,92.52715,20.33,1307.8,10695,10446,249,2.38369
17,石川県,17384,志賀町,18641,8883,9758,20422,-1781,-8.72099,91.033,246.76,75.5,7441,7493,-52,-0.69398
17,石川県,17386,宝達志水町,12129,5720,6409,13174,-1045,-7.93229,89.24949,111.52,108.8,4429,4447,-18,-0.40477
17,石川県,17407,中能登町,16552,7976,8576,17571,-1019,-5.79933,93.00373,89.45,185,6085,6055,30,0.49546
17,石川県,17461,穴水町,7897,3794,4103,8786,-889,-10.11837,92.46893,183.21,43.1,3288,3461,-173,-4.99856
17,石川県,17463,能登町,15693,7375,8318,17568,-1875,-10.67281,88.66314,273.27,57.4,6614,6904,-290,-4.20046
18,福井県,18201,福井市,262501,127883,134618,265904,-3403,-1.27979,94.99695,536.41,489.4,104317,99872,4445,4.4507
18,福井県,18202,敦賀市,64302,31800,32502,66165,-1863,-2.81569,97.84013,251.41,255.8,27791,26545,1246,4.69392
18,福井県,18204,小浜市,29019,14325,14694,29670,-651,-2.19414,97.48877,233.11,124.5,12084,11220,864,7.70053
18,福井県,18205,大野市,31324,15000,16324,33109,-1785,-5.39128,91.88924,872.43,35.9,10881,10698,183,1.7106
18,福井県,18206,勝山市,22180,10588,11592,24125,-1945,-8.06218,91.33885,253.88,87.4,7521,7703,-182,-2.36272
18,福井県,18207,鯖江市,68363,33324,35039,68284,79,0.11569,95.10545,84.59,808.2,23826,22335,1491,6.67562
18,福井県,18208,あわら市,27539,13058,14481,28729,-1190,-4.14216,90.17333,116.98,235.4,9934,9697,237,2.44405
18,福井県,18209,越前市,80667,39665,41002,81524,-857,-1.05122,96.73918,230.7,349.7,29480,27889,1591,5.70476
18,福井県,18210,坂井市,88533,42750,45783,90280,-1747,-1.93509,93.37527,209.67,422.2,30986,29454,1532,5.20133
18,福井県,18322,永平寺町,18980,9231,9749,19883,-903,-4.54157,94.68663,94.43,201,7257,7276,-19,-0.26113
18,福井県,18382,池田町,2424,1197,1227,2638,-214,-8.11221,97.55501,194.65,12.5,951,902,49,5.43237
18,福井県,18404,南越前町,10009,4803,5206,10799,-790,-7.31549,92.25893,343.69,29.1,3269,3353,-84,-2.50522
18,福井県,18423,越前町,20126,9721,10405,21538,-1412,-6.55585,93.42624,153.15,131.4,6580,6560,20,0.30488
18,福井県,18442,美浜町,9202,4618,4584,9914,-712,-7.18176,100.74171,152.35,60.4,3738,3899,-161,-4.12926
18,福井県,18481,高浜町,10332,5426,4906,10596,-264,-2.49151,110.59927,72.4,142.7,4497,4191,306,7.30136
18,福井県,18483,おおい町,7913,3971,3942,8325,-412,-4.94895,100.73567,212.19,37.3,3014,3222,-208,-6.45562
18,福井県,18501,若狭町,14019,6712,7307,15257,-1238,-8.11431,91.85712,178.49,78.5,4857,4871,-14,-0.28742
19,山梨県,19201,甲府市,189742,92895,96847,193125,-3383,-1.75172,95.91934,212.47,893,87007,85057,1950,2.29258
19,山梨県,19202,富士吉田市,46552,22648,23904,49003,-2451,-5.00173,94.74565,121.74,382.4,18335,18091,244,1.34874
19,山梨県,19204,都留市,31023,14942,16081,32002,-979,-3.05918,92.91711,161.63,191.9,14057,13465,592,4.39658
19,山梨県,19205,山梨市,33465,16085,17380,35141,-1676,-4.76936,92.54891,289.8,115.5,12991,12961,30,0.23146
19,山梨県,19206,大月市,22525,10925,11600,25419,-2894,-11.38518,94.18103,280.25,80.4,9215,9804,-589,-6.00775
19,山梨県,19207,韮崎市,29082,14504,14578,30680,-1598,-5.2086,99.49239,143.69,202.4,11523,11673,-150,-1.28502
19,山梨県,19208,南アルプス市,69494,34172,35322,70828,-1334,-1.88344,96.74424,264.14,263.1,25988,25135,853,3.39367
19,山梨県,19209,北杜市,44096,21506,22590,45111,-1015,-2.25001,95.20142,602.48,73.2,18885,18408,477,2.59126
19,山梨県,19210,甲斐市,75343,37236,38107,74386,957,1.28653,97.71433,71.95,1047.2,30951,29463,1488,5.0504
19,山梨県,19211,笛吹市,66979,32453,34526,69559,-2580,-3.70908,93.99583,201.92,331.7,26821,26268,553,2.10522
19,山梨県,19212,上野原市,22677,11336,11341,24805,-2128,-8.57892,99.95591,170.57,132.9,9480,9661,-181,-1.87351
19,山梨県,19213,甲州市,29259,14076,15183,31671,-2412,-7.6158,92.70895,264.11,110.8,11133,11389,-256,-2.24778
19,山梨県,19214,中央市,31235,15522,15713,31124,111,0.35664,98.78445,31.69,985.6,13530,12789,741,5.79404
19,山梨県,19346,市川三郷町,14710,7164,7546,15678,-968,-6.17426,94.93772,75.18,195.7,5796,5886,-90,-1.52905
19,山梨県,19364,早川町,1098,627,471,1068,30,2.80899,133.12102,369.96,3,675,573,102,17.80105
19,山梨県,19365,身延町,10655,5218,5437,12669,-2014,-15.89707,95.97204,301.98,35.3,4564,5211,-647,-12.41604
19,山梨県,19366,南部町,7157,3493,3664,8067,-910,-11.28053,95.33297,200.87,35.6,2819,3006,-187,-6.22089
19,山梨県,19368,富士川町,14225,6847,7378,15289,-1064,-6.95925,92.80293,112,127,5633,5672,-39,-0.68759
19,山梨県,19384,昭和町,20916,10444,10472,19505,1411,7.23404,99.73262,9.08,2303.5,9091,8223,868,10.55576
19,山梨県,19422,道志村,1608,811,797,1743,-135,-7.74527,101.75659,79.68,20.2,613,591,22,3.7225
19,山梨県,19423,西桂町,4041,1947,2094,4342,-301,-6.93229,92.97994,15.22,265.5,1479,1478,1,0.06766
19,山梨県,19424,忍野村,9236,5134,4102,8968,268,2.9884,125.15846,25.05,368.7,3490,3034,456,15.02966
19,山梨県,19425,山中湖村,5178,2557,2621,5208,-30,-0.57604,97.55818,53.05,97.6,1961,1855,106,5.71429
19,山梨県,19429,鳴沢村,2834,1399,1435,2921,-87,-2.97843,97.49129,89.58,31.6,1053,1036,17,1.64093
19,山梨県,19430,富士河口湖町,26084,12837,13247,25329,755,2.98077,96.90496,158.4,164.7,10621,9616,1005,10.45133
19,山梨県,19442,小菅村,684,344,340,726,-42,-5.78512,101.17647,52.78,13,339,337,2,0.59347
19,山梨県,19443,丹波山村,529,270,259,563,-34,-6.03908,104.2471,101.3,5.2,283,294,-11,-3.7415
20,長野県,20201,長野市,373251,181556,191695,377598,-4347,-1.15122,94.71087,834.81,447.1,156854,150414,6440,4.28152
20,長野県,20202,松本市,241337,118325,123012,243293,-1956,-0.80397,96.1898,978.47,246.6,104253,100173,4080,4.07295
20,長野県,20203,上田市,154155,75387,78768,156827,-2672,-1.70379,95.70765,552.04,279.2,64063,62696,1367,2.18036
20,長野県,20204,岡谷市,47820,23219,24601,50128,-2308,-4.60421,94.38234,85.1,561.9,19236,19100,136,0.71204
20,長野県,20205,飯田市,98206,47307,50899,101581,-3375,-3.32247,92.94289,658.66,149.1,38822,37694,1128,2.99252
20,長野県,20206,諏訪市,48774,23815,24959,50140,-1366,-2.72437,95.41648,109.17,446.8,20758,20401,357,1.74991
20,長野県,20207,須坂市,49583,24327,25256,50725,-1142,-2.25136,96.32167,149.67,331.3,18803,18447,356,1.92985
20,長野県,20208,小諸市,41008,19974,21034,42512,-1504,-3.53782,94.96054,98.55,416.1,16787,16662,125,0.75021
20,長野県,20209,伊那市,66111,32436,33675,68271,-2160,-3.16386,96.32071,667.93,99,26118,26231,-113,-0.43079
20,長野県,20210,駒ヶ根市,32218,15726,16492,32759,-541,-1.65145,95.35532,165.86,194.2,12885,12437,448,3.60215
20,長野県,20211,中野市,42361,20563,21798,43909,-1548,-3.52547,94.33434,112.18,377.6,15765,15296,469,3.06616
20,長野県,20212,大町市,26069,12603,13466,28041,-1972,-7.03256,93.59127,565.15,46.1,10705,10826,-121,-1.11768
20,長野県,20213,飯山市,19547,9497,10050,21438,-1891,-8.82079,94.49751,202.43,96.6,7249,7423,-174,-2.34407
20,長野県,20214,茅野市,56500,28256,28244,55912,588,1.05165,100.04249,266.59,211.9,23881,22301,1580,7.08488
20,長野県,20215,塩尻市,67302,33624,33678,67135,167,0.24875,99.83966,289.98,232.1,27992,26350,1642,6.2315
20,長野県,20217,佐久市,98300,48061,50239,99368,-1068,-1.07479,95.66472,423.51,232.1,39908,38487,1421,3.69216
20,長野県,20218,千曲市,58900,28409,30491,60298,-1398,-2.31848,93.17176,119.79,491.7,22003,21573,430,1.99323
20,長野県,20219,東御市,30154,14788,15366,30107,47,0.15611,96.23845,112.37,268.3,11247,11004,243,2.20829
20,長野県,20220,安曇野市,94278,45390,48888,95282,-1004,-1.05371,92.84487,331.78,284.2,36534,34732,1802,5.1883
20,長野県,20303,小海町,4357,2142,2215,4713,-356,-7.55358,96.70429,114.2,38.2,1793,1873,-80,-4.27122
20,長野県,20304,川上村,4350,2595,1755,4607,-257,-5.57847,147.86325,209.61,20.8,1238,1205,33,2.73859
20,長野県,20305,南牧村,3272,1822,1450,3408,-136,-3.99061,125.65517,133.09,24.6,1064,1036,28,2.7027
20,長野県,20306,南相木村,966,474,492,1005,-39,-3.8806,96.34146,66.05,14.6,410,428,-18,-4.20561
20,長野県,20307,北相木村,753,378,375,774,-21,-2.71318,100.8,56.32,13.4,366,333,33,9.90991
20,長野県,20309,佐久穂町,10217,4963,5254,11186,-969,-8.66261,94.46136,188.15,54.3,3926,4014,-88,-2.19233
20,長野県,20321,軽井沢町,19197,9181,10016,18994,203,1.06876,91.66334,156.03,123,8571,8247,324,3.9287
20,長野県,20323,御代田町,15563,7712,7851,15184,379,2.49605,98.22952,58.79,264.7,6687,6118,569,9.30042
20,長野県,20324,立科町,6617,3326,3291,7265,-648,-8.91948,101.06351,66.87,99,2605,2682,-77,-2.87099
20,長野県,20349,青木村,4124,1978,2146,4343,-219,-5.0426,92.17148,57.1,72.2,1555,1556,-1,-0.06427
20,長野県,20350,長和町,5606,2780,2826,6166,-560,-9.08206,98.37226,183.86,30.5,2310,2416,-106,-4.38742
20,長野県,20361,下諏訪町,19171,9242,9929,20236,-1065,-5.2629,93.08087,66.87,286.7,7907,7946,-39,-0.49081
20,長野県,20362,富士見町,14108,6848,7260,14493,-385,-2.65645,94.32507,144.76,97.5,5591,5396,195,3.61379
20,長野県,20363,原村,7684,3772,3912,7566,118,1.55961,96.42127,43.26,177.6,2853,2673,180,6.73401
20,長野県,20382,辰野町,18562,9018,9544,19770,-1208,-6.11027,94.48868,169.2,109.7,7255,7343,-88,-1.19842
20,長野県,20383,箕輪町,24981,12506,12475,25241,-260,-1.03007,100.2485,85.91,290.8,9450,9240,210,2.27273
20,長野県,20384,飯島町,9007,4392,4615,9530,-523,-5.48793,95.16793,86.96,103.6,3387,3325,62,1.86466
20,長野県,20385,南箕輪村,15817,7858,7959,15063,754,5.00564,98.731,40.99,385.9,6434,5839,595,10.1901
20,長野県,20386,中川村,4649,2189,2460,4850,-201,-4.14433,88.98374,77.05,60.3,1586,1584,2,0.12626
20,長野県,20388,宮田村,8570,4163,4407,8821,-251,-2.84548,94.46335,54.5,157.2,3268,3122,146,4.67649
20,長野県,20402,松川町,12539,6073,6466,13167,-628,-4.7695,93.92205,72.79,172.3,4445,4355,90,2.06659
20,長野県,20403,高森町,12814,6158,6656,13080,-266,-2.03364,92.51803,45.36,282.5,4426,4247,179,4.21474
20,長野県,20404,阿南町,4302,2075,2227,4962,-660,-13.30109,93.17467,123.07,35,1614,1737,-123,-7.08117
20,長野県,20407,阿智村,6071,2894,3177,6538,-467,-7.14286,91.09223,214.43,28.3,2151,2188,-37,-1.69104
20,長野県,20409,平谷村,389,192,197,484,-95,-19.6281,97.46193,77.37,5,196,211,-15,-7.109
20,長野県,20410,根羽村,853,411,442,970,-117,-12.06186,92.98643,89.97,9.5,383,416,-33,-7.93269
20,長野県,20411,下條村,3545,1709,1836,3851,-306,-7.94599,93.08279,38.12,93,1160,1159,1,0.08628
20,長野県,20412,売木村,549,251,298,575,-26,-4.52174,84.22819,43.43,12.6,279,270,9,3.33333
20,長野県,20413,天龍村,1175,556,619,1365,-190,-13.91941,89.82229,109.44,10.7,569,651,-82,-12.59601
20,長野県,20414,泰阜村,1542,726,816,1702,-160,-9.40071,88.97059,64.59,23.9,604,639,-35,-5.47731
20,長野県,20415,喬木村,5977,2909,3068,6310,-333,-5.27734,94.81747,66.61,89.7,2035,2029,6,0.29571
20,長野県,20416,豊丘村,6430,3188,3242,6592,-162,-2.45752,98.33436,76.79,83.7,2123,2054,69,3.3593
20,長野県,20417,大鹿村,1021,538,483,1023,-2,-0.1955,111.38716,248.28,4.1,462,475,-13,-2.73684
20,長野県,20422,上松町,4123,2037,2086,4670,-547,-11.71306,97.65101,168.42,24.5,1755,1864,-109,-5.84764
20,長野県,20423,南木曽町,3917,1896,2021,4313,-396,-9.18154,93.81494,215.93,18.1,1626,1713,-87,-5.07881
20,長野県,20425,木祖村,2694,1236,1458,2926,-232,-7.92891,84.77366,140.5,19.2,1014,1045,-31,-2.96651
20,長野県,20429,王滝村,716,338,378,839,-123,-14.66031,89.41799,310.82,2.3,371,398,-27,-6.78392
20,長野県,20430,大桑村,3439,1681,1758,3825,-386,-10.0915,95.62002,234.47,14.7,1477,1522,-45,-2.95664
20,長野県,20432,木曽町,10583,5153,5430,11826,-1243,-10.51074,94.89871,476.03,22.2,4679,4942,-263,-5.32173
20,長野県,20446,麻績村,2595,1219,1376,2788,-193,-6.92253,88.59012,34.38,75.5,970,1001,-31,-3.0969
20,長野県,20448,生坂村,1640,818,822,1843,-203,-11.01465,99.51338,39.05,42,673,698,-25,-3.58166
20,長野県,20450,山形村,8404,4106,4298,8395,9,0.10721,95.53281,24.98,336.4,3013,2725,288,10.56881
20,長野県,20451,朝日村,4282,2110,2172,4462,-180,-4.03407,97.14549,70.62,60.6,1475,1412,63,4.46176
20,長野県,20452,筑北村,4150,2051,2099,4730,-580,-12.26216,97.7132,99.47,41.7,1683,1780,-97,-5.44944
20,長野県,20481,池田町,9388,4555,4833,9926,-538,-5.42011,94.24788,40.16,233.8,3543,3518,25,0.71063
20,長野県,20482,松川村,9611,4608,5003,9948,-337,-3.38762,92.10474,47.07,204.2,3575,3497,78,2.23048
20,長野県,20485,白馬村,8585,4260,4325,8929,-344,-3.85262,98.49711,189.36,45.3,3691,3477,214,6.15473
20,長野県,20486,小谷村,2645,1369,1276,2904,-259,-8.91873,107.2884,267.91,9.9,1140,1195,-55,-4.60251
20,長野県,20521,坂城町,14020,6919,7101,14871,-851,-5.72255,97.43698,53.64,261.4,5420,5473,-53,-0.96839
20,長野県,20541,小布施町,10661,5124,5537,10702,-41,-0.38311,92.54109,19.12,557.6,3682,3528,154,4.36508
20,長野県,20543,高山村,6626,3246,3380,7033,-407,-5.787,96.0355,98.56,67.2,2320,2291,29,1.26582
20,長野県,20561,山ノ内町,11363,5530,5833,12429,-1066,-8.57672,94.80542,265.9,42.7,4413,4465,-52,-1.16461
20,長野県,20562,木島平村,4374,2117,2257,4658,-284,-6.09704,93.79708,99.32,44,1684,1564,120,7.67263
20,長野県,20563,野沢温泉村,3278,1567,1711,3479,-201,-5.77752,91.58387,57.96,56.6,1153,1159,-6,-0.51769
20,長野県,20583,信濃町,7745,3814,3931,8469,-724,-8.54883,97.02366,149.3,51.9,3062,3157,-95,-3.00919
20,長野県,20588,小川村,2225,1104,1121,2665,-440,-16.51032,98.4835,58.11,38.3,968,1086,-118,-10.86556
20,長野県,20590,飯綱町,10300,5017,5283,11063,-763,-6.89686,94.96498,75,137.3,3767,3769,-2,-0.05306
20,長野県,20602,栄村,1667,804,863,1953,-286,-14.64414,93.16338,271.66,6.1,693,775,-82,-10.58065
21,岐阜県,21201,岐阜市,402742,191690,211052,406735,-3993,-0.98172,90.82596,203.6,1978.1,173204,165443,7761,4.69104
21,岐阜県,21202,大垣市,158342,77009,81333,159879,-1537,-0.96135,94.68358,206.57,766.5,61994,60085,1909,3.17717
21,岐阜県,21203,高山市,84463,40486,43977,89182,-4719,-5.29143,92.06176,2177.61,38.8,32746,32670,76,0.23263
21,岐阜県,21204,多治見市,106810,51441,55369,110441,-3631,-3.28773,92.90578,91.25,1170.5,42555,41446,1109,2.67577
21,岐阜県,21205,関市,85283,41671,43612,89153,-3870,-4.34085,95.54939,472.33,180.6,33574,32827,747,2.27557
21,岐阜県,21206,中津川市,76658,37414,39244,78883,-2225,-2.82063,95.33687,676.45,113.3,29445,28438,1007,3.54104
21,岐阜県,21207,美濃市,19267,9295,9972,20760,-1493,-7.19171,93.21099,117.01,164.7,7423,7508,-85,-1.13213
21,岐阜県,21208,瑞浪市,37175,18156,19019,38730,-1555,-4.01498,95.46243,174.86,212.6,14482,13904,578,4.15708
21,岐阜県,21209,羽島市,65684,32313,33371,67337,-1653,-2.45482,96.82958,53.66,1224.1,24714,23948,766,3.1986
21,岐阜県,21210,恵那市,47818,23154,24664,51073,-3255,-6.37323,93.87772,504.24,94.8,18102,18106,-4,-0.02209
21,岐阜県,21211,美濃加茂市,56718,28138,28580,55384,1334,2.40864,98.45346,74.81,758.2,21729,20501,1228,5.98995
21,岐阜県,21212,土岐市,55374,26816,28558,57827,-2453,-4.24196,93.90013,116.02,477.3,21311,21039,272,1.29284
21,岐阜県,21213,各務原市,144619,71253,73366,144690,-71,-0.04907,97.11992,87.81,1647,57002,53470,3532,6.60557
21,岐阜県,21214,可児市,100037,49221,50816,98695,1342,1.35974,96.86122,87.57,1142.4,39598,37171,2427,6.52928
21,岐阜県,21216,瑞穂市,56411,28115,28296,54354,2057,3.78445,99.36033,28.19,2001.1,22463,21011,1452,6.91067
21,岐阜県,21217,飛騨市,22556,10864,11692,24696,-2140,-8.66537,92.91823,792.53,28.5,8183,8509,-326,-3.83124
21,岐阜県,21218,本巣市,32940,15938,17002,33995,-1055,-3.1034,93.74191,374.65,87.9,11700,11346,354,3.12004
21,岐阜県,21219,郡上市,39003,19051,19952,42090,-3087,-7.33428,95.48416,1030.75,37.8,14546,14610,-64,-0.43806
21,岐阜県,21220,下呂市,30443,14469,15974,33585,-3142,-9.35537,90.57844,851.21,35.8,11686,12140,-454,-3.7397
21,岐阜県,21221,海津市,32749,16050,16699,35206,-2457,-6.97892,96.11354,112.03,292.3,11598,11513,85,0.7383
21,岐阜県,21302,岐南町,25890,12668,13222,24622,1268,5.14987,95.81001,7.91,3273.1,10527,9560,967,10.11506
21,岐阜県,21303,笠松町,22220,10514,11706,22750,-530,-2.32967,89.81719,10.3,2157.3,8580,8191,389,4.74911
21,岐阜県,21341,養老町,26897,13123,13774,29029,-2132,-7.34438,95.2737,72.29,372.1,9340,9378,-38,-0.4052
21,岐阜県,21361,垂井町,26419,12988,13431,27556,-1137,-4.12614,96.70166,57.09,462.8,9545,9374,171,1.82419
21,岐阜県,21362,関ケ原町,6612,3203,3409,7419,-807,-10.87748,93.95717,49.28,134.2,2492,2625,-133,-5.06667
21,岐阜県,21381,神戸町,18587,9098,9489,19282,-695,-3.6044,95.87944,18.78,989.7,6794,6572,222,3.37797
21,岐阜県,21382,輪之内町,9664,4808,4856,9973,-309,-3.09837,99.01153,22.33,432.8,3437,3138,299,9.52836
21,岐阜県,21383,安八町,14355,7040,7315,14752,-397,-2.69116,96.2406,18.16,790.5,5002,4713,289,6.13198
21,岐阜県,21401,揖斐川町,19535,9364,10171,21503,-1968,-9.15221,92.06568,803.44,24.3,7041,7269,-228,-3.13661
21,岐阜県,21403,大野町,22048,10780,11268,23453,-1405,-5.9907,95.66915,34.2,644.7,7541,7366,175,2.37578
21,岐阜県,21404,池田町,23378,11426,11952,24347,-969,-3.97996,95.59906,38.8,602.5,8402,7897,505,6.39483
21,岐阜県,21421,北方町,18148,8652,9496,18169,-21,-0.11558,91.11205,5.18,3503.5,7373,7139,234,3.27777
21,岐阜県,21501,坂祝町,8069,4165,3904,8202,-133,-1.62156,106.68545,12.87,627,3189,3111,78,2.50723
21,岐阜県,21502,富加町,5627,2704,2923,5564,63,1.13228,92.5077,16.82,334.5,1973,1834,139,7.57906
21,岐阜県,21503,川辺町,9866,4868,4998,10197,-331,-3.24605,97.39896,41.16,239.7,3695,3561,134,3.76299
21,岐阜県,21504,七宗町,3408,1609,1799,3876,-468,-12.0743,89.43858,90.47,37.7,1312,1381,-69,-4.99638
21,岐阜県,21505,八百津町,10201,4907,5294,11027,-826,-7.4907,92.68984,128.79,79.2,3877,3892,-15,-0.38541
21,岐阜県,21506,白川町,7417,3487,3930,8392,-975,-11.61821,88.72774,237.9,31.2,2878,3002,-124,-4.13058
21,岐阜県,21507,東白川村,2017,964,1053,2261,-244,-10.79169,91.54796,87.09,23.2,780,817,-37,-4.52876
21,岐阜県,21521,御嵩町,17529,8767,8762,18111,-582,-3.21352,100.05706,56.69,309.2,6737,6514,223,3.4234
21,岐阜県,21604,白川村,1511,755,756,1609,-98,-6.09074,99.86772,356.64,4.2,580,553,27,4.88246
22,静岡県,22100,静岡市,693759,337888,355871,704989,-11230,-1.59293,94.94676,1411.83,491.4,296778,286013,10765,3.76381
22,静岡県,22101,静岡市葵区,249451,120009,129442,253593,-4142,-1.63333,92.71257,1073.75,232.3,105040,101673,3367,3.3116
22,静岡県,22102,静岡市駿河区,213107,105156,107951,212419,688,0.32389,97.41086,73.06,2916.9,96030,90631,5399,5.95712
22,静岡県,22103,静岡市清水区,231201,112723,118478,238977,-7776,-3.25387,95.14256,265.02,872.4,95708,93709,1999,2.1332
22,静岡県,22130,浜松市,791155,393046,398109,797980,-6825,-0.85528,98.72824,1558.06,507.8,319900,309227,10673,3.45151
22,静岡県,22131,浜松市中区,235373,117413,117960,237443,-2070,-0.87179,99.53628,44.34,5308.4,107956,106191,1765,1.6621
22,静岡県,22132,浜松市東区,129410,64377,65033,128555,855,0.66508,98.99128,46.29,2795.6,52318,50106,2212,4.41464
22,静岡県,22133,浜松市西区,108198,53488,54710,111353,-3155,-2.83333,97.7664,114.71,943.2,39710,38730,980,2.53034
22,静岡県,22134,浜松市南区,99826,50037,49789,100870,-1044,-1.035,100.4981,46.84,2131.2,40053,38259,1794,4.68909
22,静岡県,22135,浜松市北区,92792,45698,47094,93567,-775,-0.82828,97.03572,295.54,314,33908,32017,1891,5.90624
22,静岡県,22136,浜松市浜北区,98823,49088,49735,95900,2923,3.04797,98.69911,66.5,1486.1,35350,32493,2857,8.79266
22,静岡県,22137,浜松市天竜区,26733,12945,13788,30292,-3559,-11.74898,93.88599,943.84,28.3,10605,11431,-826,-7.22596
22,静岡県,22203,沼津市,189611,93094,96517,195633,-6022,-3.07821,96.45347,186.96,1014.2,83210,80798,2412,2.98522
22,静岡県,22205,熱海市,34233,15440,18793,37544,-3311,-8.81899,82.15825,61.78,554.1,18466,18846,-380,-2.01634
22,静岡県,22206,三島市,107851,52440,55411,110046,-2195,-1.99462,94.63825,62.02,1739,46017,45218,799,1.767
22,静岡県,22207,富士宮市,128147,63390,64757,130770,-2623,-2.00581,97.88903,389.08,329.4,51297,49004,2293,4.67921
22,静岡県,22208,伊東市,65529,30684,34845,68345,-2816,-4.12027,88.05854,124.1,528,30776,30478,298,0.97775
22,静岡県,22209,島田市,95759,46740,49019,98112,-2353,-2.39828,95.35078,315.7,303.3,35363,34310,1053,3.06908
22,静岡県,22210,富士市,245489,120723,124766,248399,-2910,-1.1715,96.75953,244.95,1002.2,97214,92581,4633,5.00427
22,静岡県,22211,磐田市,166744,83993,82751,167210,-466,-0.27869,101.50089,163.45,1020.2,64808,61346,3462,5.6434
22,静岡県,22212,焼津市,136891,66959,69932,139462,-2571,-1.84351,95.74873,70.31,1947,53158,50648,2510,4.95577
22,静岡県,22213,掛川市,114989,57700,57289,114602,387,0.33769,100.71742,265.69,432.8,43588,41050,2538,6.1827
22,静岡県,22214,藤枝市,141385,68816,72569,143605,-2220,-1.54591,94.82837,194.06,728.6,53886,52315,1571,3.00296
22,静岡県,22215,御殿場市,86689,44452,42237,88078,-1389,-1.57701,105.24422,194.9,444.8,33362,31610,1752,5.54255
22,静岡県,22216,袋井市,87882,44544,43338,85789,2093,2.43971,102.78278,108.33,811.2,33844,31453,2391,7.60182
22,静岡県,22219,下田市,20195,9679,10516,22916,-2721,-11.8738,92.0407,104.38,193.5,9633,10397,-764,-7.34827
22,静岡県,22220,裾野市,50945,25776,25169,52737,-1792,-3.39799,102.4117,138.12,368.8,20708,20792,-84,-0.404
22,静岡県,22221,湖西市,57907,29627,28280,59789,-1882,-3.14774,104.76308,86.56,669,22845,22546,299,1.32618
22,静岡県,22222,伊豆市,28264,13362,14902,31317,-3053,-9.7487,89.66582,363.97,77.7,11488,12158,-670,-5.51077
22,静岡県,22223,御前崎市,31117,15810,15307,32578,-1461,-4.48462,103.28608,65.56,474.6,11463,11345,118,1.04011
22,静岡県,22224,菊川市,47823,24174,23649,46763,1060,2.26675,102.21997,94.19,507.7,17715,16095,1620,10.06524
22,静岡県,22225,伊豆の国市,46820,22458,24362,48152,-1332,-2.76624,92.18455,94.62,494.8,19062,18677,385,2.06136
22,静岡県,22226,牧之原市,43524,21431,22093,45547,-2023,-4.44157,97.00358,111.69,389.7,15686,15416,270,1.75143
22,静岡県,22301,東伊豆町,11487,5441,6046,12624,-1137,-9.00665,89.99338,77.81,147.6,5564,5620,-56,-0.99644
22,静岡県,22302,河津町,6884,3326,3558,7303,-419,-5.73737,93.47948,100.69,68.4,2929,2919,10,0.34258
22,静岡県,22304,南伊豆町,7923,3754,4169,8524,-601,-7.05068,90.04557,109.94,72.1,3314,3435,-121,-3.52256
22,静岡県,22305,松崎町,6039,2838,3201,6837,-798,-11.67179,88.65979,85.19,70.9,2663,2832,-169,-5.96751
22,静岡県,22306,西伊豆町,7089,3351,3738,8234,-1145,-13.90576,89.64687,105.54,67.2,3399,3673,-274,-7.45984
22,静岡県,22325,函南町,36802,17914,18888,37661,-859,-2.28087,94.84329,65.16,564.8,14752,14317,435,3.03835
22,静岡県,22341,清水町,31720,15405,16315,32118,-398,-1.23918,94.42231,8.81,3600.5,12934,12363,571,4.61862
22,静岡県,22342,長泉町,43365,21438,21927,42331,1034,2.44265,97.76987,26.63,1628.4,17460,16427,1033,6.28843
22,静岡県,22344,小山町,18585,9846,8739,19497,-912,-4.67764,112.66735,135.74,136.9,6432,6431,1,0.01555
22,静岡県,22424,吉田町,28937,14417,14520,29093,-156,-0.53621,99.29063,20.73,1395.9,11149,10244,905,8.83444
22,静岡県,22429,川根本町,6206,3055,3151,7192,-986,-13.70968,96.95335,496.88,12.5,2632,2883,-251,-8.70621
22,静岡県,22461,森町,17475,8708,8767,18528,-1053,-5.68329,99.32702,133.91,130.5,6240,6133,107,1.74466
23,愛知県,23100,名古屋市,2333406,1146556,1186850,2295638,37768,1.64521,96.60496,326.5,7146.7,1117930,1058497,59433,5.61485
23,愛知県,23101,名古屋市千種区,165420,80260,85160,164696,724,0.4396,94.24612,18.18,9099,86100,85028,1072,1.26076
23,愛知県,23102,名古屋市東区,84410,40426,43984,78043,6367,8.15832,91.91069,7.71,10948.1,45581,41311,4270,10.33623
23,愛知県,23103,名古屋市北区,163282,79276,84006,163579,-297,-0.18156,94.36945,17.53,9314.4,78862,75428,3434,4.55269
23,愛知県,23104,名古屋市西区,151198,74789,76409,149098,2100,1.40847,97.87983,17.93,8432.7,73776,70078,3698,5.27698
23,愛知県,23105,名古屋市中村区,138660,70102,68558,133206,5454,4.09441,102.25211,16.3,8506.7,74679,66039,8640,13.08318
23,愛知県,23106,名古屋市中区,93283,46104,47179,83203,10080,12.11495,97.72144,9.38,9944.9,62719,53533,9186,17.15951
23,愛知県,23107,名古屋市昭和区,107698,52996,54702,107170,528,0.49268,96.88128,10.94,9844.4,55089,55108,-19,-0.03448
23,愛知県,23108,名古屋市瑞穂区,108423,51999,56424,105357,3066,2.91011,92.15759,11.22,9663.4,51591,48629,2962,6.09102
23,愛知県,23109,名古屋市熱田区,66956,33348,33608,65895,1061,1.61014,99.22637,8.2,8165.4,33611,31884,1727,5.41651
23,愛知県,23110,名古屋市中川区,220738,108932,111806,220281,457,0.20746,97.42948,32.02,6893.8,100419,95495,4924,5.15629
23,愛知県,23111,名古屋市港区,143764,72203,71561,146745,-2981,-2.03142,100.89714,45.69,3146.5,63461,61713,1748,2.83247
23,愛知県,23112,名古屋市南区,134631,68356,66275,136935,-2304,-1.68255,103.13995,18.46,7293.1,62133,61064,1069,1.75062
23,愛知県,23113,名古屋市守山区,176512,86037,90475,172845,3667,2.12155,95.09478,34.01,5190,74794,69687,5107,7.32848
23,愛知県,23114,名古屋市緑区,248914,122015,126899,241822,7092,2.93274,96.15127,37.91,6565.9,101323,95210,6113,6.42054
23,愛知県,23115,名古屋市名東区,164677,78791,85886,164080,597,0.36385,91.73905,19.45,8466.7,75913,73922,1991,2.69338
23,愛知県,23116,名古屋市天白区,164840,80922,83918,162683,2157,1.32589,96.42985,21.58,7638.6,77879,74368,3511,4.72112
23,愛知県,23201,豊橋市,372134,186217,185917,374765,-2631,-0.70204,100.16136,261.86,1421.1,150633,144222,6411,4.44523
23,愛知県,23202,岡崎市,384805,193692,191113,381051,3754,0.98517,101.34946,387.2,993.8,156116,147418,8698,5.90023
23,愛知県,23203,一宮市,379981,184796,195185,380868,-887,-0.23289,94.67736,113.82,3338.4,151666,142480,9186,6.44722
23,愛知県,23204,瀬戸市,127869,62603,65266,129046,-1177,-0.91208,95.91977,111.4,1147.8,52275,50327,1948,3.87069
23,愛知県,23205,半田市,117925,59374,58551,116908,1017,0.86991,101.40561,47.42,2486.8,48895,46281,2614,5.64811
23,愛知県,23206,春日井市,308832,152353,156479,306508,2324,0.75822,97.36322,92.78,3328.6,130683,124291,6392,5.14277
23,愛知県,23207,豊川市,184659,91959,92700,182436,2223,1.21851,99.20065,161.14,1146,71734,67976,3758,5.52842
23,愛知県,23208,津島市,60958,29664,31294,63431,-2473,-3.89872,94.79133,25.09,2429.6,24131,23833,298,1.25037
23,愛知県,23209,碧南市,72528,37324,35204,71346,1182,1.65672,106.02204,36.68,1977.3,28040,26477,1563,5.90324
23,愛知県,23210,刈谷市,153926,80203,73723,149765,4161,2.77835,108.78966,50.39,3054.7,67772,62476,5296,8.47686
23,愛知県,23211,豊田市,422511,220755,201756,422542,-31,-0.00734,109.41682,918.32,460.1,176535,169598,6937,4.09026
23,愛知県,23212,安城市,188512,96513,91999,184140,4372,2.37428,104.90658,86.05,2190.7,74777,70862,3915,5.52482
23,愛知県,23213,西尾市,169127,85615,83512,167990,1137,0.67683,102.5182,161.22,1049,61619,58951,2668,4.52579
23,愛知県,23214,蒲郡市,79501,39312,40189,81100,-1599,-1.97164,97.81781,56.92,1396.7,30783,29950,833,2.7813
23,愛知県,23215,犬山市,73122,36247,36875,74308,-1186,-1.59606,98.29695,74.9,976.3,29248,28269,979,3.46316
23,愛知県,23216,常滑市,58735,28579,30156,56547,2188,3.86935,94.77053,55.9,1050.7,24461,22506,1955,8.68657
23,愛知県,23217,江南市,98284,47914,50370,98359,-75,-0.07625,95.12408,30.2,3254.4,38637,37130,1507,4.05871
23,愛知県,23219,小牧市,149033,75373,73660,149462,-429,-0.28703,102.32555,62.81,2372.8,62035,59383,2652,4.46592
23,愛知県,23220,稲沢市,134738,66400,68338,136867,-2129,-1.55552,97.1641,79.35,1698,51769,49986,1783,3.567
23,愛知県,23221,新城市,44382,22009,22373,47133,-2751,-5.83667,98.37304,499.23,88.9,16604,16454,150,0.91163
23,愛知県,23222,東海市,113838,59172,54666,111944,1894,1.69192,108.24278,43.43,2621.2,49016,46371,2645,5.704
23,愛知県,23223,大府市,93154,47381,45773,89157,3997,4.4831,103.51299,33.66,2767.5,38042,35669,2373,6.65284
23,愛知県,23224,知多市,84371,42326,42045,84617,-246,-0.29072,100.66833,45.9,1838.1,33903,33009,894,2.70835
23,愛知県,23225,知立市,72248,38146,34102,70501,1747,2.47798,111.85854,16.31,4429.7,31516,29312,2204,7.5191
23,愛知県,23226,尾張旭市,83182,40452,42730,80787,2395,2.96459,94.66885,21.03,3955.4,33779,31806,1973,6.20323
23,愛知県,23227,高浜市,46064,23765,22299,46236,-172,-0.372,106.57429,13.11,3513.7,18084,17684,400,2.26193
23,愛知県,23228,岩倉市,48003,23867,24136,47562,441,0.92721,98.88548,10.47,4584.8,21364,20390,974,4.77685
23,愛知県,23229,豊明市,69312,35067,34245,69127,185,0.26762,102.40035,23.22,2985,28897,27504,1393,5.06472
23,愛知県,23230,日進市,91566,45176,46390,87977,3589,4.07948,97.38306,34.91,2622.9,36445,34210,2235,6.53318
23,愛知県,23231,田原市,59379,30143,29236,62364,-2985,-4.78642,103.10234,191.12,310.7,21030,21640,-610,-2.81885
23,愛知県,23232,愛西市,60839,29542,31297,63088,-2249,-3.56486,94.39243,66.68,912.4,21628,21131,497,2.35199
23,愛知県,23233,清須市,67464,33554,33910,67327,137,0.20348,98.95016,17.35,3888.4,28859,27056,1803,6.66396
23,愛知県,23234,北名古屋市,86447,43075,43372,84133,2314,2.75041,99.31523,18.37,4705.9,36015,33742,2273,6.73641
23,愛知県,23235,弥富市,43001,21454,21547,43269,-268,-0.61938,99.56839,49.11,875.6,16974,16050,924,5.75701
23,愛知県,23236,みよし市,61965,32108,29857,61810,155,0.25077,107.53927,32.19,1925,24054,22552,1502,6.66016
23,愛知県,23237,あま市,86185,42585,43600,86898,-713,-0.8205,97.67202,27.49,3135.1,33910,33190,720,2.16933
23,愛知県,23238,長久手市,60112,29132,30980,57598,2514,4.36473,94.03486,21.55,2789.4,26425,25069,1356,5.40907
23,愛知県,23302,東郷町,44128,22152,21976,42858,1270,2.96327,100.80087,18.03,2447.5,16776,15766,1010,6.40619
23,愛知県,23342,豊山町,15615,7940,7675,15177,438,2.88595,103.45277,6.18,2526.7,6575,6181,394,6.37437
23,愛知県,23361,大口町,24262,12219,12043,23274,988,4.24508,101.46143,13.61,1782.7,9053,8316,737,8.86243
23,愛知県,23362,扶桑町,34136,16841,17295,33806,330,0.97616,97.37496,11.19,3050.6,13468,12679,789,6.22289
23,愛知県,23424,大治町,32403,16298,16105,30990,1413,4.55954,101.19839,6.59,4917,13439,12105,1334,11.02024
23,愛知県,23425,蟹江町,37351,18433,18918,37085,266,0.71727,97.4363,11.09,3368,15952,14971,981,6.55267
23,愛知県,23427,飛島村,4580,2261,2319,4397,183,4.16193,97.49892,22.42,204.3,1528,1259,269,21.36616
23,愛知県,23441,阿久比町,28400,13971,14429,27747,653,2.35341,96.82584,23.8,1193.3,10080,9627,453,4.70552
23,愛知県,23442,東浦町,49659,24744,24915,49230,429,0.87142,99.31367,31.14,1594.7,19419,18524,895,4.83157
23,愛知県,23445,南知多町,16621,8074,8547,18707,-2086,-11.15091,94.46589,38.37,433.2,6526,6981,-455,-6.51769
23,愛知県,23446,美浜町,22491,11214,11277,23575,-1084,-4.59809,99.44134,46.2,486.8,9509,9314,195,2.09362
23,愛知県,23447,武豊町,43565,22127,21438,42473,1092,2.57105,103.21392,26.38,1651.4,18094,16724,1370,8.19182
23,愛知県,23501,幸田町,42479,21508,20971,39549,2930,7.40853,102.56068,56.72,748.9,15782,13693,2089,15.25597
23,愛知県,23561,設楽町,4445,2167,2278,5074,-629,-12.39653,95.1273,273.94,16.2,1849,2015,-166,-8.23821
23,愛知県,23562,東栄町,2942,1415,1527,3446,-504,-14.62565,92.66536,123.38,23.8,1296,1436,-140,-9.7493
23,愛知県,23563,豊根村,1017,482,535,1135,-118,-10.39648,90.09346,155.88,6.5,437,490,-53,-10.81633
24,三重県,24201,津市,274759,133547,141212,279886,-5127,-1.83182,94.57199,711.19,386.3,117175,114679,2496,2.17651
24,三重県,24202,四日市市,305744,152708,153036,311031,-5287,-1.69983,99.78567,206.52,1480.5,132731,128309,4422,3.44637
24,三重県,24203,伊勢市,122855,58166,64689,127817,-4962,-3.88211,89.91637,208.35,589.7,51571,50938,633,1.24269
24,三重県,24204,松阪市,159231,76393,82838,163863,-4632,-2.82675,92.21975,623.58,255.3,65540,63948,1592,2.48952
24,三重県,24205,桑名市,138671,68096,70575,140303,-1632,-1.1632,96.48742,136.68,1014.6,56169,53741,2428,4.51797
24,三重県,24207,鈴鹿市,195742,97355,98387,196403,-661,-0.33655,98.95108,194.46,1006.6,82096,77725,4371,5.62367
24,三重県,24208,名張市,76414,36862,39552,78795,-2381,-3.02177,93.19883,129.77,588.8,31497,30595,902,2.94819
24,三重県,24209,尾鷲市,16257,7556,8701,18009,-1752,-9.72847,86.84059,192.71,84.4,8148,8660,-512,-5.91224
24,三重県,24210,亀山市,49878,25164,24714,50254,-376,-0.7482,101.82083,191.04,261.1,20525,19945,580,2.908
24,三重県,24211,鳥羽市,17537,8256,9281,19448,-1911,-9.8262,88.95593,107.34,163.4,7383,7730,-347,-4.489
24,三重県,24212,熊野市,15966,7381,8585,17322,-1356,-7.8282,85.97554,373.35,42.8,7746,8151,-405,-4.96872
24,三重県,24214,いなべ市,45000,23111,21889,45815,-815,-1.77889,105.58271,219.83,204.7,17973,17106,867,5.0684
24,三重県,24215,志摩市,46104,21220,24884,50341,-4237,-8.4166,85.27568,178.95,257.6,19556,20057,-501,-2.49788
24,三重県,24216,伊賀市,88863,43470,45393,90581,-1718,-1.89664,95.76366,558.23,159.2,36360,33651,2709,8.05028
24,三重県,24303,木曽岬町,6020,3028,2992,6357,-337,-5.30124,101.20321,15.74,382.5,2303,2174,129,5.93376
24,三重県,24324,東員町,25791,12608,13183,25344,447,1.76373,95.63832,22.68,1137.2,9541,8863,678,7.64978
24,三重県,24341,菰野町,40571,19875,20696,40210,361,0.89779,96.03305,107.01,379.1,15364,14423,941,6.5243
24,三重県,24343,朝日町,11022,5489,5533,10560,462,4.375,99.20477,5.99,1840.1,4103,3852,251,6.5161
24,三重県,24344,川越町,15131,7804,7327,14752,379,2.56914,106.51017,8.73,1733.2,6585,6023,562,9.3309
24,三重県,24441,多気町,14017,6746,7271,14878,-861,-5.78707,92.77954,103.06,136,5120,5160,-40,-0.77519
24,三重県,24442,明和町,22473,10675,11798,22586,-113,-0.50031,90.48144,41.04,547.6,8053,7697,356,4.62518
24,三重県,24443,大台町,8675,4105,4570,9557,-882,-9.22884,89.82495,362.86,23.9,3634,3778,-144,-3.81154
24,三重県,24461,玉城町,15044,7182,7862,15431,-387,-2.50794,91.3508,40.91,367.7,5387,5260,127,2.41445
24,三重県,24470,度会町,7852,3800,4052,8309,-457,-5.50006,93.78085,134.98,58.2,2668,2626,42,1.59939
24,三重県,24471,大紀町,7822,3652,4170,8939,-1117,-12.4958,87.57794,233.32,33.5,3406,3691,-285,-7.72148
24,三重県,24472,南伊勢町,10979,5091,5888,12788,-1809,-14.14607,86.46399,241.89,45.4,4962,5432,-470,-8.65243
24,三重県,24543,紀北町,14618,6756,7862,16338,-1720,-10.5276,85.93233,256.54,57,6819,7269,-450,-6.19067
24,三重県,24561,御浜町,8081,3768,4313,8741,-660,-7.55062,87.36378,88.13,91.7,3717,3862,-145,-3.75453
24,三重県,24562,紀宝町,10323,4765,5558,11207,-884,-7.88793,85.73228,79.62,129.7,4738,4947,-209,-4.22478
25,滋賀県,25201,大津市,345202,166754,178448,340973,4229,1.24027,93.44683,464.51,743.2,146270,136153,10117,7.43061
25,滋賀県,25202,彦根市,113693,56500,57193,113679,14,0.01232,98.78831,196.87,577.5,48158,45546,2612,5.73486
25,滋賀県,25203,長浜市,113719,55411,58308,118193,-4474,-3.78533,95.03156,681.02,167,42527,41788,739,1.76845
25,滋賀県,25204,近江八幡市,81170,39692,41478,81312,-142,-0.17464,95.6941,177.45,457.4,31324,29784,1540,5.17056
25,滋賀県,25206,草津市,143958,72634,71324,137247,6711,4.88972,101.83669,67.82,2122.6,66857,60224,6633,11.01388
25,滋賀県,25207,守山市,83271,40875,42396,79859,3412,4.27253,96.4124,55.74,1493.9,31633,29052,2581,8.88407
25,滋賀県,25208,栗東市,68879,34193,34686,66749,2130,3.19106,98.57868,52.69,1307.2,26662,24592,2070,8.41737
25,滋賀県,25209,甲賀市,88417,44030,44387,90901,-2484,-2.73264,99.19571,481.62,183.6,33512,32366,1146,3.54075
25,滋賀県,25210,野洲市,50541,25115,25426,49889,652,1.3069,98.77684,80.14,630.7,19610,18143,1467,8.08576
25,滋賀県,25211,湖南市,54492,28175,26317,54289,203,0.37392,107.06008,70.4,774,22291,21286,1005,4.72141
25,滋賀県,25212,高島市,46379,22758,23621,50025,-3646,-7.28836,96.34647,693.05,66.9,18033,18149,-116,-0.63915
25,滋賀県,25213,東近江市,112872,56287,56585,114180,-1308,-1.14556,99.47336,388.37,290.6,42615,40691,1924,4.72832
25,滋賀県,25214,米原市,37201,18044,19157,38719,-1518,-3.92056,94.19011,250.39,148.6,13368,13236,132,0.99728
25,滋賀県,25383,日野町,20975,10555,10420,21873,-898,-4.10552,101.29559,117.6,178.4,7914,7728,186,2.40683
25,滋賀県,25384,竜王町,11797,6200,5597,12434,-637,-5.12305,110.77363,44.55,264.8,4353,4266,87,2.03938
25,滋賀県,25425,愛荘町,20895,10377,10518,20778,117,0.5631,98.65944,37.97,550.3,7815,7209,606,8.40616
25,滋賀県,25441,豊郷町,7139,3465,3674,7422,-283,-3.81299,94.31138,7.8,915.3,2601,2606,-5,-0.19186
25,滋賀県,25442,甲良町,6365,3061,3304,7039,-674,-9.57522,92.64528,13.63,467,2189,2310,-121,-5.2381
25,滋賀県,25443,多賀町,7283,3504,3779,7355,-72,-0.97893,92.72294,135.77,53.6,2491,2421,70,2.89137
26,京都府,26100,京都市,1464890,692310,772580,1475183,-10293,-0.69774,89.61014,827.83,1769.6,727566,705874,21692,3.07307
26,京都府,26101,京都市北区,117252,55732,61520,119474,-2222,-1.85982,90.59168,94.88,1235.8,57021,56804,217,0.38202
26,京都府,26102,京都市上京区,83949,38571,45378,85113,-1164,-1.36759,84.99934,7.03,11941.5,47955,46849,1106,2.36078
26,京都府,26103,京都市左京区,166254,79942,86312,168266,-2012,-1.19573,92.6198,246.77,673.7,85268,83423,1845,2.21162
26,京都府,26104,京都市中京区,110557,50519,60038,109341,1216,1.11212,84.14504,7.41,14920,60597,59085,1512,2.55903
26,京都府,26105,京都市東山区,36651,16091,20560,39044,-2393,-6.12898,78.26362,7.48,4899.9,20482,21381,-899,-4.20467
26,京都府,26106,京都市下京区,82811,38103,44708,82668,143,0.17298,85.22636,6.78,12214,48107,47206,901,1.90866
26,京都府,26107,京都市南区,102034,50629,51405,99927,2107,2.10854,98.49042,15.81,6453.8,50389,47094,3295,6.99665
26,京都府,26108,京都市右京区,202193,94904,107289,204262,-2069,-1.01291,88.45641,292.07,692.3,97658,94525,3133,3.31447
26,京都府,26109,京都市伏見区,278131,133098,145033,280655,-2524,-0.89932,91.77084,61.66,4510.7,130849,125947,4902,3.89211
26,京都府,26110,京都市山科区,135194,63522,71672,135471,-277,-0.20447,88.62875,28.7,4710.6,64265,60451,3814,6.30924
26,京都府,26111,京都市西京区,149864,71199,78665,150962,-1098,-0.72734,90.50912,59.24,2529.8,64975,63109,1866,2.95679
26,京都府,26201,福知山市,77349,38505,38844,78935,-1586,-2.00925,99.12728,552.54,140,33609,32170,1439,4.47311
26,京都府,26202,舞鶴市,80383,40248,40135,83990,-3607,-4.29456,100.28155,342.13,234.9,35250,34709,541,1.55867
26,京都府,26203,綾部市,31878,15253,16625,33821,-1943,-5.74495,91.74737,347.1,91.8,13703,13766,-63,-0.45765
26,京都府,26204,宇治市,179783,86345,93438,184678,-4895,-2.65056,92.40887,67.54,2661.9,73502,73317,185,0.25233
26,京都府,26205,宮津市,16769,7943,8826,18426,-1657,-8.99273,89.99547,172.74,97.1,7298,7738,-440,-5.68622
26,京都府,26206,亀岡市,86197,41659,44538,89479,-3282,-3.6679,93.53586,224.8,383.4,34333,33915,418,1.23249
26,京都府,26207,城陽市,74643,35864,38779,76869,-2226,-2.89584,92.48304,32.71,2282,30429,29884,545,1.82372
26,京都府,26208,向日市,56882,27102,29780,53380,3502,6.56051,91.00739,7.72,7368.1,23527,21356,2171,10.16576
26,京都府,26209,長岡京市,80649,38797,41852,80090,559,0.69796,92.70047,19.17,4207,33621,32491,1130,3.47789
26,京都府,26210,八幡市,70479,34021,36458,72664,-2185,-3.00699,93.3156,24.35,2894.4,30383,29259,1124,3.84155
26,京都府,26211,京田辺市,73773,36107,37666,70835,2938,4.14767,95.86099,42.92,1718.8,31628,29693,1935,6.51669
26,京都府,26212,京丹後市,50867,24361,26506,55054,-4187,-7.60526,91.90749,501.44,101.4,20100,20469,-369,-1.80273
26,京都府,26213,南丹市,31650,15396,16254,33145,-1495,-4.51048,94.7213,616.4,51.3,13273,12783,490,3.83322
26,京都府,26214,木津川市,77960,37326,40634,72840,5120,7.0291,91.85903,85.13,915.8,29858,26656,3202,12.0123
26,京都府,26303,大山崎町,15970,7720,8250,15181,789,5.19729,93.57576,5.97,2675,6548,5993,555,9.2608
26,京都府,26322,久御山町,15280,7433,7847,15805,-525,-3.32173,94.7241,13.86,1102.5,6246,6216,30,0.48263
26,京都府,26343,井手町,7411,3597,3814,7910,-499,-6.30847,94.31044,18.04,410.8,3223,3059,164,5.36123
26,京都府,26344,宇治田原町,8923,4501,4422,9319,-396,-4.24938,101.78652,58.16,153.4,3421,3232,189,5.84777
26,京都府,26364,笠置町,1142,540,602,1368,-226,-16.52047,89.701,23.52,48.6,523,573,-50,-8.726
26,京都府,26365,和束町,3483,1617,1866,3956,-473,-11.95652,86.65595,64.93,53.6,1376,1445,-69,-4.77509
26,京都府,26366,精華町,36220,17233,18987,36376,-156,-0.42885,90.7621,25.68,1410.4,13537,12775,762,5.96477
26,京都府,26367,南山城村,2390,1124,1266,2652,-262,-9.87934,88.78357,64.11,37.3,1023,1068,-45,-4.21348
26,京都府,26407,京丹波町,12913,6114,6799,14453,-1540,-10.65523,89.92499,303.09,42.6,5212,5448,-236,-4.33186
26,京都府,26463,伊根町,1930,946,984,2110,-180,-8.53081,96.13821,61.95,31.2,850,873,-23,-2.63459
26,京都府,26465,与謝野町,20107,9545,10562,21834,-1727,-7.90968,90.37114,108.38,185.5,8067,8140,-73,-0.89681
27,大阪府,27100,大阪市,2754742,1327024,1427718,2691185,63557,2.36167,92.94721,225.32,12225.9,1465136,1354793,110343,8.14464
27,大阪府,27102,大阪市都島区,107986,51759,56227,104727,3259,3.1119,92.05364,6.08,17760.9,56725,51549,5176,10.04093
27,大阪府,27103,大阪市福島区,79397,37642,41755,72484,6913,9.53728,90.14968,4.67,17001.5,42373,37510,4863,12.96454
27,大阪府,27104,大阪市此花区,65304,31600,33704,66656,-1352,-2.02832,93.75742,19.28,3387.1,32143,30712,1431,4.65942
27,大阪府,27106,大阪市西区,105891,49600,56291,92430,13461,14.56345,88.11355,5.21,20324.6,63791,52138,11653,22.3503
27,大阪府,27107,大阪市港区,81001,39497,41504,82035,-1034,-1.26044,95.16432,7.86,10305.5,42581,40348,2233,5.53435
27,大阪府,27108,大阪市大正区,62149,30183,31966,65141,-2992,-4.59311,94.4222,9.43,6590.6,29791,29209,582,1.99254
27,大阪府,27109,大阪市天王寺区,82216,37996,44220,75729,6487,8.56607,85.92492,4.84,16986.8,42037,38058,3979,10.45509
27,大阪府,27111,大阪市浪速区,75628,38430,37198,69766,5862,8.40237,103.31201,4.39,17227.3,53094,47541,5553,11.68044
27,大阪府,27113,大阪市西淀川区,95957,47096,48861,95490,467,0.48906,96.38771,14.21,6752.8,46183,42924,3259,7.59249
27,大阪府,27114,大阪市東淀川区,177286,86680,90606,175530,1756,1.0004,95.66695,13.27,13359.9,99406,92536,6870,7.42414
27,大阪府,27115,大阪市東成区,85024,40333,44691,80563,4461,5.53728,90.2486,4.54,18727.8,45501,39683,5818,14.66119
27,大阪府,27116,大阪市生野区,127479,60344,67135,130167,-2688,-2.06504,89.88456,8.37,15230.5,67378,63622,3756,5.90362
27,大阪府,27117,大阪市旭区,89755,42692,47063,91608,-1853,-2.02275,90.71245,6.32,14201.7,45192,43700,1492,3.41419
27,大阪府,27118,大阪市城東区,169135,80220,88915,164697,4438,2.69465,90.221,8.38,20183.2,82726,76455,6271,8.20221
27,大阪府,27119,大阪市阿倍野区,111141,51179,59962,107626,3515,3.26594,85.35239,5.98,18585.5,53527,50104,3423,6.83179
27,大阪府,27120,大阪市住吉区,153225,71228,81997,154239,-1014,-0.65742,86.86659,9.4,16300.5,78081,71718,6363,8.87225
27,大阪府,27121,大阪市東住吉区,127960,60134,67826,126299,1661,1.31513,88.65922,9.75,13124.1,61860,57797,4063,7.02978
27,大阪府,27122,大阪市西成区,106219,61318,44901,111883,-5664,-5.06243,136.56266,7.37,14412.3,65747,69225,-3478,-5.0242
27,大阪府,27123,大阪市淀川区,183586,91343,92243,176201,7385,4.19124,99.02432,12.64,14524.2,103820,94460,9360,9.90896
27,大阪府,27124,大阪市鶴見区,112754,53179,59575,111557,1197,1.07299,89.26395,8.17,13801,48781,46358,2423,5.22671
27,大阪府,27125,大阪市住之江区,120157,57610,62547,122988,-2831,-2.30185,92.10674,20.68,5810.3,59770,56920,2850,5.00703
27,大阪府,27126,大阪市平野区,192211,90536,101675,196633,-4422,-2.24886,89.0445,15.28,12579.3,92413,88960,3453,3.88152
27,大阪府,27127,大阪市北区,139502,67784,71718,123667,15835,12.80455,94.51463,10.34,13491.5,85213,74182,11031,14.87018
27,大阪府,27128,大阪市中央区,103779,48641,55138,93069,10710,11.50759,88.21684,8.87,11700,67003,59084,7919,13.40295
27,大阪府,27140,堺市,826447,393880,432567,839310,-12863,-1.53257,91.05641,149.83,5515.9,366110,350301,15809,4.51298
27,大阪府,27141,堺市堺区,148801,73617,75184,148205,596,0.40215,97.91578,23.66,6289.1,73843,69116,4727,6.83923
27,大阪府,27142,堺市中区,121277,58083,63194,124543,-3266,-2.62239,91.91221,17.88,6782.8,50250,48538,1712,3.52713
27,大阪府,27143,堺市東区,85072,40399,44673,85189,-117,-0.13734,90.4327,10.49,8109.8,36927,34722,2205,6.35044
27,大阪府,27144,堺市西区,135462,64560,70902,135746,-284,-0.20921,91.05526,28.62,4733.1,58064,54614,3450,6.31706
27,大阪府,27145,堺市南区,138519,64138,74381,147626,-9107,-6.16897,86.22901,40.39,3429.5,59728,60427,-699,-1.15677
27,大阪府,27146,堺市北区,159688,74968,84720,158845,843,0.53071,88.48914,15.6,10236.4,72515,68538,3977,5.80262
27,大阪府,27147,堺市美原区,37628,18115,19513,39156,-1528,-3.90234,92.83555,13.2,2850.6,14783,14346,437,3.04615
27,大阪府,27202,岸和田市,190796,90418,100378,194911,-4115,-2.11122,90.07751,72.72,2623.7,78670,75247,3423,4.54902
27,大阪府,27203,豊中市,401818,188933,212885,395479,6339,1.60287,88.74886,36.39,11042,176755,170325,6430,3.77514
27,大阪府,27204,池田市,105017,49968,55049,103069,1948,1.89,90.77004,22.14,4743.3,48620,45777,2843,6.21054
27,大阪府,27205,吹田市,385787,185316,200471,374468,11319,3.02269,92.4403,36.09,10689.6,179656,168473,11183,6.63786
27,大阪府,27206,泉大津市,74431,35216,39215,75897,-1466,-1.93157,89.80237,14.33,5194.1,32497,31090,1407,4.52557
27,大阪府,27207,高槻市,352876,168083,184793,351829,1047,0.29759,90.95745,105.29,3351.5,152686,148048,4638,3.13277
27,大阪府,27208,貝塚市,84463,40481,43982,88694,-4231,-4.77033,92.03993,43.93,1922.7,33213,33355,-142,-0.42572
27,大阪府,27209,守口市,143063,69140,73923,143042,21,0.01468,93.52975,12.71,11255.9,67745,64832,2913,4.49315
27,大阪府,27210,枚方市,397596,188373,209223,404152,-6556,-1.62216,90.03456,65.12,6105.6,172375,167418,4957,2.96085
27,大阪府,27211,茨木市,288014,138621,149393,280033,7981,2.85002,92.78949,76.49,3765.4,125086,116683,8403,7.20156
27,大阪府,27212,八尾市,264654,125839,138815,268800,-4146,-1.54241,90.65231,41.72,6343.6,113886,110414,3472,3.14453
27,大阪府,27213,泉佐野市,100182,47822,52360,100966,-784,-0.7765,91.33308,56.51,1772.8,43767,41566,2201,5.29519
27,大阪府,27214,富田林市,108768,50937,57831,113984,-5216,-4.57608,88.07906,39.72,2738.4,45416,45613,-197,-0.43189
27,大阪府,27215,寝屋川市,229749,110767,118982,237518,-7769,-3.27091,93.09559,24.7,9301.6,101439,101549,-110,-0.10832
27,大阪府,27216,河内長野市,101764,47397,54367,106987,-5223,-4.8819,87.17972,109.63,928.2,42267,42144,123,0.29186
27,大阪府,27217,松原市,117611,56517,61094,120750,-3139,-2.59959,92.50827,16.66,7059.5,51742,49958,1784,3.571
27,大阪府,27218,大東市,119184,57836,61348,123217,-4033,-3.27309,94.27528,18.27,6523.5,52411,51949,462,0.88933
27,大阪府,27219,和泉市,184634,88769,95865,186109,-1475,-0.79255,92.59792,84.98,2172.7,73670,71013,2657,3.74157
27,大阪府,27220,箕面市,136954,65001,71953,133411,3543,2.6557,90.33814,47.9,2859.2,58090,56829,1261,2.21894
27,大阪府,27221,柏原市,68789,32960,35829,71112,-2323,-3.26668,91.99252,25.33,2715.7,29685,29009,676,2.33031
27,大阪府,27222,羽曳野市,108872,51098,57774,112683,-3811,-3.38205,88.44463,26.45,4116.1,44933,44126,807,1.82885
27,大阪府,27223,門真市,119807,58805,61002,123576,-3769,-3.04994,96.39848,12.3,9740.4,57371,55825,1546,2.76937
27,大阪府,27224,摂津市,87497,43172,44325,85007,2490,2.92917,97.39876,14.87,5884.1,40195,36873,3322,9.0093
27,大阪府,27225,高石市,55599,26302,29297,56529,-930,-1.64517,89.77711,11.3,4920.3,23086,22461,625,2.7826
27,大阪府,27226,藤井寺市,63714,29954,33760,65438,-1724,-2.63455,88.7263,8.89,7166.9,27818,27133,685,2.5246
27,大阪府,27227,東大阪市,494074,240292,253782,502784,-8710,-1.73235,94.68441,61.78,7997.3,231335,223485,7850,3.51254
27,大阪府,27228,泉南市,60139,28732,31407,62438,-2299,-3.68205,91.48279,48.98,1227.8,23012,22800,212,0.92982
27,大阪府,27229,四條畷市,55198,26747,28451,56075,-877,-1.56398,94.01076,18.69,2953.3,22381,22089,292,1.32192
27,大阪府,27230,交野市,75077,35818,39259,76435,-1358,-1.77667,91.23513,25.55,2938.4,29663,28923,740,2.55852
27,大阪府,27231,大阪狭山市,58486,27427,31059,57792,694,1.20086,88.30613,11.92,4906.5,24161,22982,1179,5.1301
27,大阪府,27232,阪南市,51262,24234,27028,54276,-3014,-5.5531,89.66257,36.17,1417.3,20948,20710,238,1.1492
27,大阪府,27301,島本町,30899,14596,16303,29983,916,3.05506,89.52953,16.81,1838.1,12718,12012,706,5.87746
27,大阪府,27321,豊能町,18284,8679,9605,19934,-1650,-8.27732,90.35919,34.34,532.4,7579,7760,-181,-2.33247
27,大阪府,27322,能勢町,9062,4330,4732,10256,-1194,-11.64197,91.50465,98.75,91.8,3595,3717,-122,-3.28222
27,大阪府,27341,忠岡町,16571,7953,8618,17298,-727,-4.2028,92.28359,3.97,4174.1,6719,6726,-7,-0.10407
27,大阪府,27361,熊取町,43796,21305,22491,44435,-639,-1.43806,94.72678,17.24,2540.4,17339,16483,856,5.19323
27,大阪府,27362,田尻町,8438,4176,4262,8417,21,0.2495,97.98217,5.62,1501.4,3732,3772,-40,-1.06045
27,大阪府,27366,岬町,14787,6837,7950,15938,-1151,-7.22173,86,49.18,300.7,6374,6407,-33,-0.51506
27,大阪府,27381,太子町,13001,6318,6683,13748,-747,-5.43352,94.53838,14.17,917.5,5048,5066,-18,-0.35531
27,大阪府,27382,河南町,15718,7635,8083,16126,-408,-2.53008,94.4575,25.26,622.2,6408,6115,293,4.7915
27,大阪府,27383,千早赤阪村,4903,2315,2588,5378,-475,-8.83228,89.45131,37.3,131.4,1946,2036,-90,-4.42043
28,兵庫県,28100,神戸市,1527022,717052,809970,1537272,-10250,-0.66677,88.52822,557.02,2741.4,734314,705459,28855,4.09024
28,兵庫県,28101,神戸市東灘区,213773,99473,114300,213634,139,0.06506,87.028,34.02,6283.7,102205,97265,4940,5.07891
28,兵庫県,28102,神戸市灘区,136854,63578,73276,136088,766,0.56287,86.76511,32.66,4190.3,69936,67407,2529,3.75184
28,兵庫県,28105,神戸市兵庫区,109270,52936,56334,106956,2314,2.16351,93.96812,14.67,7448.5,61105,57875,3230,5.58099
28,兵庫県,28106,神戸市長田区,94933,44698,50235,97912,-2979,-3.04253,88.9778,11.36,8356.8,49499,48780,719,1.47396
28,兵庫県,28107,神戸市須磨区,158888,73108,85780,162468,-3580,-2.20351,85.22733,28.93,5492.2,74205,73278,927,1.26505
28,兵庫県,28108,神戸市垂水区,215562,100345,115217,219474,-3912,-1.78244,87.09218,28.11,7668.5,97662,95473,2189,2.29279
28,兵庫県,28109,神戸市北区,210747,99554,111193,219805,-9058,-4.12093,89.53261,240.29,877.1,88411,87126,1285,1.47488
28,兵庫県,28110,神戸市中央区,147715,68308,79407,135153,12562,9.29465,86.02264,28.97,5098.9,91125,81022,10103,12.46945
28,兵庫県,28111,神戸市西区,239280,115052,124228,245782,-6502,-2.64543,92.61358,138.01,1733.8,100166,97233,2933,3.01647
28,兵庫県,28201,姫路市,530723,256665,274058,535664,-4941,-0.92241,93.65353,534.56,992.8,223611,212801,10810,5.07986
28,兵庫県,28202,尼崎市,459717,222242,237475,452563,7154,1.58077,93.58543,50.72,9063.8,221152,210433,10719,5.09378
28,兵庫県,28203,明石市,303838,146778,157060,293409,10429,3.55442,93.45346,49.42,6148.1,133661,121890,11771,9.65707
28,兵庫県,28204,西宮市,485705,226078,259627,487850,-2145,-0.43968,87.078,99.96,4859,215188,210965,4223,2.00175
28,兵庫県,28205,洲本市,41329,19651,21678,44258,-2929,-6.61801,90.64951,182.38,226.6,17790,18081,-291,-1.60942
28,兵庫県,28206,芦屋市,94038,42034,52004,95350,-1312,-1.37598,80.8284,18.47,5091.4,42505,41881,624,1.48994
28,兵庫県,28207,伊丹市,198244,95637,102607,196883,1361,0.69127,93.20709,25,7929.8,82546,78903,3643,4.61706
28,兵庫県,28208,相生市,28374,13594,14780,30129,-1755,-5.82495,91.97564,90.4,313.9,11747,12153,-406,-3.34074
28,兵庫県,28209,豊岡市,77519,37307,40212,82250,-4731,-5.75198,92.77579,697.55,111.1,30168,30189,-21,-0.06956
28,兵庫県,28210,加古川市,260988,127544,133444,267435,-6447,-2.41068,95.57867,138.48,1884.7,106977,103495,3482,3.36441
28,兵庫県,28212,赤穂市,45921,22109,23812,48567,-2646,-5.44814,92.84814,126.85,362,18880,18729,151,0.80624
28,兵庫県,28213,西脇市,38714,18545,20169,40866,-2152,-5.26599,91.94804,132.44,292.3,15164,15049,115,0.76417
28,兵庫県,28214,宝塚市,226658,103701,122957,224903,1755,0.78034,84.33924,101.8,2226.5,95518,94140,1378,1.46378
28,兵庫県,28215,三木市,75373,36266,39107,77178,-1805,-2.33875,92.73532,176.51,427,29944,28653,1291,4.50564
28,兵庫県,28216,高砂市,87758,42402,45356,91030,-3272,-3.59442,93.48708,34.38,2552.6,36715,36340,375,1.03192
28,兵庫県,28217,川西市,152473,71294,81179,156375,-3902,-2.49528,87.82321,53.44,2853.2,63344,62675,669,1.06741
28,兵庫県,28218,小野市,47591,23238,24353,48580,-989,-2.03582,95.42151,92.94,512.1,17570,16860,710,4.21115
28,兵庫県,28219,三田市,109324,52339,56985,112691,-3367,-2.98782,91.84698,210.32,519.8,42335,41070,1265,3.08011
28,兵庫県,28220,加西市,42750,21086,21664,44313,-1563,-3.52718,97.33198,150.98,283.2,16143,15364,779,5.07029
28,兵庫県,28221,丹波篠山市,39637,18816,20821,41490,-1853,-4.46614,90.3703,377.59,105,15591,15578,13,0.08345
28,兵庫県,28222,養父市,22137,10628,11509,24288,-2151,-8.85623,92.34512,422.91,52.3,8385,8713,-328,-3.76449
28,兵庫県,28223,丹波市,61511,29473,32038,64660,-3149,-4.87009,91.99388,493.21,124.7,22997,22553,444,1.9687
28,兵庫県,28224,南あわじ市,44180,21122,23058,46912,-2732,-5.82367,91.60378,229.01,192.9,17025,16968,57,0.33593
28,兵庫県,28225,朝来市,29002,13885,15117,30805,-1803,-5.85295,91.85023,403.06,72,11384,11500,-116,-1.0087
28,兵庫県,28226,淡路市,42028,19880,22148,43977,-1949,-4.43186,89.7598,184.32,228,17444,17451,-7,-0.04011
28,兵庫県,28227,宍粟市,34852,16636,18216,37773,-2921,-7.73304,91.32631,658.54,52.9,12896,12723,173,1.35974
28,兵庫県,28228,加東市,40683,19963,20720,40310,373,0.92533,96.34653,157.55,258.2,16598,15086,1512,10.02254
28,兵庫県,28229,たつの市,74355,35930,38425,77419,-3064,-3.95768,93.50683,210.87,352.6,27775,27297,478,1.75111
28,兵庫県,28301,猪名川町,29703,13977,15726,30838,-1135,-3.68052,88.87829,90.33,328.8,10911,10780,131,1.21521
28,兵庫県,28365,多可町,19284,9318,9966,21200,-1916,-9.03774,93.49789,185.19,104.1,6528,6665,-137,-2.05551
28,兵庫県,28381,稲美町,30268,14767,15501,31020,-752,-2.42424,95.26482,34.92,866.8,11296,11026,270,2.44876
28,兵庫県,28382,播磨町,33561,16292,17269,33739,-178,-0.52758,94.34246,9.13,3675.9,13781,13258,523,3.94479
28,兵庫県,28442,市川町,11239,5481,5758,12300,-1061,-8.62602,95.1893,82.67,136,4317,4334,-17,-0.39225
28,兵庫県,28443,福崎町,19376,9454,9922,19738,-362,-1.83403,95.28321,45.79,423.1,7771,6906,865,12.52534
28,兵庫県,28446,神河町,10633,4963,5670,11452,-819,-7.15159,87.53086,202.23,52.6,3777,3798,-21,-0.55292
28,兵庫県,28464,太子町,33498,16250,17248,33690,-192,-0.5699,94.21382,22.61,1481.6,12740,12092,648,5.35891
28,兵庫県,28481,上郡町,13896,6722,7174,15224,-1328,-8.72307,93.69947,150.26,92.5,5596,5715,-119,-2.08224
28,兵庫県,28501,佐用町,15885,7570,8315,17510,-1625,-9.28041,91.04029,307.44,51.7,5953,6108,-155,-2.53766
28,兵庫県,28585,香美町,16069,7634,8435,18070,-2001,-11.0736,90.50385,368.77,43.6,5905,6228,-323,-5.18626
28,兵庫県,28586,新温泉町,13328,6299,7029,14819,-1491,-10.06141,89.61445,241.01,55.3,4923,5291,-368,-6.95521
29,奈良県,29201,奈良市,354833,164875,189958,360310,-5477,-1.52008,86.7955,276.94,1281.3,154690,148920,5770,3.87456
29,奈良県,29202,大和高田市,61779,28969,32810,64817,-3038,-4.68704,88.2932,16.48,3748.7,26056,25619,437,1.70577
29,奈良県,29203,大和郡山市,83276,39225,44051,87050,-3774,-4.33544,89.04452,42.69,1950.7,34166,34138,28,0.08202
29,奈良県,29204,天理市,63941,31296,32645,67398,-3457,-5.12923,95.86767,86.42,739.9,25541,25810,-269,-1.04223
29,奈良県,29205,橿原市,120972,57342,63630,124111,-3139,-2.52919,90.11787,39.56,3057.9,51280,49923,1357,2.71819
29,奈良県,29206,桜井市,54870,25907,28963,57244,-2374,-4.14716,89.44861,98.91,554.7,22030,21672,358,1.6519
29,奈良県,29207,五條市,27947,13178,14769,30997,-3050,-9.83966,89.22744,292.02,95.7,10979,11199,-220,-1.96446
29,奈良県,29208,御所市,24113,11125,12988,26868,-2755,-10.25383,85.65599,60.58,398,10099,10415,-316,-3.03409
29,奈良県,29209,生駒市,116951,55232,61719,118233,-1282,-1.0843,89.48946,53.15,2200.4,47638,45593,2045,4.48534
29,奈良県,29210,香芝市,78148,36924,41224,77561,587,0.75682,89.56918,24.26,3221.3,29565,27802,1763,6.34127
29,奈良県,29211,葛城市,36845,17532,19313,36635,210,0.57322,90.77823,33.72,1092.7,13269,12544,725,5.77966
29,奈良県,29212,宇陀市,28144,13377,14767,31105,-2961,-9.51937,90.58712,247.5,113.7,10761,11155,-394,-3.53205
29,奈良県,29322,山添村,3227,1540,1687,3674,-447,-12.16658,91.28631,66.52,48.5,1112,1144,-32,-2.7972
29,奈良県,29342,平群町,18025,8452,9573,18883,-858,-4.54377,88.28998,23.9,754.2,7185,7158,27,0.3772
29,奈良県,29343,三郷町,23233,10881,12352,23571,-338,-1.43397,88.091,8.79,2643.1,9501,9155,346,3.77936
29,奈良県,29344,斑鳩町,27611,12991,14620,27303,308,1.12808,88.85773,14.27,1934.9,10897,10330,567,5.48887
29,奈良県,29345,安堵町,7225,3384,3841,7443,-218,-2.92893,88.10206,4.31,1676.3,3066,2875,191,6.64348
29,奈良県,29361,川西町,8165,3940,4225,8485,-320,-3.77136,93.25444,5.93,1376.9,3206,3248,-42,-1.2931
29,奈良県,29362,三宅町,6443,3050,3393,6836,-393,-5.74898,89.89095,4.06,1586.9,2629,2629,0,0
29,奈良県,29363,田原本町,31213,14883,16330,31691,-478,-1.50831,91.13901,21.09,1480,11898,11463,435,3.79482
29,奈良県,29385,曽爾村,1294,594,700,1549,-255,-16.46223,84.85714,47.76,27.1,590,622,-32,-5.14469
29,奈良県,29386,御杖村,1480,695,785,1759,-279,-15.86128,88.53503,79.58,18.6,703,748,-45,-6.01604
29,奈良県,29401,高取町,6736,3140,3596,7195,-459,-6.37943,87.31924,25.79,261.2,2322,2396,-74,-3.08848
29,奈良県,29402,明日香村,5237,2472,2765,5523,-286,-5.17835,89.40325,24.1,217.3,1801,1779,22,1.23665
29,奈良県,29424,上牧町,21715,10113,11602,22054,-339,-1.53714,87.16601,6.14,3536.6,8650,8085,565,6.98825
29,奈良県,29425,王寺町,24054,11377,12677,23025,1029,4.46906,89.74521,7.01,3431.4,10026,9347,679,7.26436
29,奈良県,29426,広陵町,33842,16069,17773,33487,355,1.06011,90.41242,16.3,2076.2,11915,11012,903,8.20015
29,奈良県,29427,河合町,17032,7916,9116,17941,-909,-5.06661,86.83633,8.23,2069.5,6785,6712,73,1.0876
29,奈良県,29441,吉野町,6232,2840,3392,7399,-1167,-15.7724,83.72642,95.65,65.2,2651,2946,-295,-10.01358
29,奈良県,29442,大淀町,16728,7938,8790,18069,-1341,-7.42155,90.30717,38.1,439.1,6492,6509,-17,-0.26118
29,奈良県,29443,下市町,5042,2356,2686,5664,-622,-10.98164,87.71407,61.99,81.3,2141,2232,-91,-4.07706
29,奈良県,29444,黒滝村,626,296,330,660,-34,-5.15152,89.69697,47.7,13.1,306,311,-5,-1.60772
29,奈良県,29446,天川村,1179,568,611,1354,-175,-12.92467,92.96236,175.66,6.7,561,628,-67,-10.66879
29,奈良県,29447,野迫川村,358,176,182,449,-91,-20.26726,96.7033,154.9,2.3,204,227,-23,-10.13216
29,奈良県,29449,十津川村,3063,1664,1399,3508,-445,-12.68529,118.9421,672.38,4.6,1410,1578,-168,-10.64639
29,奈良県,29450,下北山村,751,359,392,895,-144,-16.08939,91.58163,133.39,5.6,447,517,-70,-13.53965
29,奈良県,29451,上北山村,446,227,219,512,-66,-12.89063,103.65297,274.22,1.6,268,270,-2,-0.74074
29,奈良県,29452,川上村,1159,554,605,1313,-154,-11.72887,91.57025,269.26,4.3,621,680,-59,-8.67647
29,奈良県,29453,東吉野村,1502,703,799,1745,-243,-13.9255,87.98498,131.65,11.4,764,830,-66,-7.95181
30,和歌山県,30201,和歌山市,356858,167954,188904,364154,-7296,-2.00355,88.90971,208.85,1708.7,157786,153089,4697,3.06815
30,和歌山県,30202,海南市,48400,22545,25855,51860,-3460,-6.67181,87.19783,101.06,478.9,20085,20678,-593,-2.86778
30,和歌山県,30203,橋本市,60863,28633,32230,63621,-2758,-4.33505,88.83959,130.55,466.2,24018,23653,365,1.54314
30,和歌山県,30204,有田市,26553,12579,13974,28470,-1917,-6.7334,90.01717,36.83,721,10270,10576,-306,-2.89334
30,和歌山県,30205,御坊市,23488,11400,12088,24801,-1313,-5.29414,94.30841,43.91,534.9,10107,9913,194,1.95703
30,和歌山県,30206,田辺市,69906,32798,37108,74770,-4864,-6.50528,88.38525,1026.91,68.1,31214,32163,-949,-2.9506
30,和歌山県,30207,新宮市,27187,12613,14574,29331,-2144,-7.30967,86.54453,255.23,106.5,13158,13617,-459,-3.37079
30,和歌山県,30208,紀の川市,58856,27826,31030,62616,-3760,-6.00485,89.67451,228.21,257.9,23311,23457,-146,-0.62242
30,和歌山県,30209,岩出市,53993,25972,28021,53452,541,1.01212,92.68763,38.51,1402.1,21950,20774,1176,5.66092
30,和歌山県,30304,紀美野町,8264,3796,4468,9206,-942,-10.23246,84.95971,128.34,64.4,3474,3762,-288,-7.6555
30,和歌山県,30341,かつらぎ町,15990,7432,8558,16992,-1002,-5.89689,86.84272,151.69,105.4,6224,6315,-91,-1.44101
30,和歌山県,30343,九度山町,3859,1781,2078,4377,-518,-11.83459,85.70741,44.15,87.4,1527,1649,-122,-7.39842
30,和歌山県,30344,高野町,2969,1496,1473,3352,-383,-11.42601,101.56144,137.03,21.7,1416,1468,-52,-3.54223
30,和歌山県,30361,湯浅町,11117,5189,5928,12200,-1083,-8.87705,87.53374,20.79,534.7,4609,4755,-146,-3.07045
30,和歌山県,30362,広川町,6785,3194,3591,7224,-439,-6.07697,88.94458,65.33,103.9,2480,2503,-23,-0.9189
30,和歌山県,30366,有田川町,25274,11947,13327,26361,-1087,-4.12352,89.64508,351.84,71.8,9505,9426,79,0.83811
30,和歌山県,30381,美浜町,6866,3217,3649,7480,-614,-8.20856,88.16114,12.77,537.7,2859,2964,-105,-3.54251
30,和歌山県,30382,日高町,7673,3657,4016,7641,32,0.41879,91.06076,46.19,166.1,2893,2782,111,3.98994
30,和歌山県,30383,由良町,5373,2687,2686,5837,-464,-7.94929,100.03723,30.94,173.7,2260,2223,37,1.66442
30,和歌山県,30390,印南町,7722,3660,4062,8068,-346,-4.28855,90.1034,113.62,68,2973,2918,55,1.88485
30,和歌山県,30391,みなべ町,11823,5605,6218,12742,-919,-7.21237,90.14152,120.28,98.3,4279,4421,-142,-3.21194
30,和歌山県,30392,日高川町,9223,4449,4774,9776,-553,-5.65671,93.19229,331.59,27.8,3579,3650,-71,-1.94521
30,和歌山県,30401,白浜町,20270,9441,10829,21533,-1263,-5.86542,87.18257,200.98,100.9,9381,9538,-157,-1.64605
30,和歌山県,30404,上富田町,15240,7250,7990,14989,251,1.67456,90.73842,57.37,265.6,6363,6017,346,5.75037
30,和歌山県,30406,すさみ町,3687,1748,1939,4127,-440,-10.6615,90.14956,174.45,21.1,1776,1927,-151,-7.83601
30,和歌山県,30421,那智勝浦町,14144,6532,7612,15682,-1538,-9.80742,85.81188,183.31,77.2,6774,7296,-522,-7.15461
30,和歌山県,30422,太地町,2797,1231,1566,3087,-290,-9.39423,78.60792,5.81,481.4,1320,1384,-64,-4.62428
30,和歌山県,30424,古座川町,2480,1129,1351,2826,-346,-12.24345,83.56773,294.23,8.4,1242,1378,-136,-9.86938
30,和歌山県,30427,北山村,404,183,221,446,-42,-9.41704,82.80543,48.2,8.4,223,239,-16,-6.69456
30,和歌山県,30428,串本町,14969,7146,7823,16558,-1589,-9.59657,91.34603,135.67,110.3,7399,7797,-398,-5.10453
31,鳥取県,31201,鳥取市,188614,91382,97232,193717,-5103,-2.63426,93.98346,765.31,246.5,76717,75941,776,1.02185
31,鳥取県,31202,米子市,147421,69756,77665,149313,-1892,-1.26714,89.81652,132.42,1113.3,61755,60037,1718,2.86157
31,鳥取県,31203,倉吉市,46526,21839,24687,49044,-2518,-5.13417,88.46356,272.06,171,18240,18548,-308,-1.66056
31,鳥取県,31204,境港市,32760,15779,16981,34174,-1414,-4.13765,92.9215,29.11,1125.4,13130,13094,36,0.27494
31,鳥取県,31302,岩美町,10811,5180,5631,11485,-674,-5.86852,91.99077,122.32,88.4,3921,3993,-72,-1.80316
31,鳥取県,31325,若桜町,2868,1356,1512,3269,-401,-12.26675,89.68254,199.18,14.4,1182,1271,-89,-7.00236
31,鳥取県,31328,智頭町,6436,3008,3428,7154,-718,-10.03634,87.74796,224.7,28.6,2400,2487,-87,-3.49819
31,鳥取県,31329,八頭町,15945,7613,8332,16985,-1040,-6.12305,91.37062,206.71,77.1,5327,5359,-32,-0.59713
31,鳥取県,31364,三朝町,6068,2876,3192,6490,-422,-6.50231,90.10025,233.52,26,2227,2290,-63,-2.75109
31,鳥取県,31370,湯梨浜町,16062,7657,8405,16550,-488,-2.94864,91.10054,77.94,206.1,5681,5482,199,3.63006
31,鳥取県,31371,琴浦町,16373,7678,8695,17416,-1043,-5.98875,88.30362,139.97,117,5768,5795,-27,-0.46592
31,鳥取県,31372,北栄町,14238,6817,7421,14820,-582,-3.92713,91.86094,56.94,250.1,4985,4813,172,3.57365
31,鳥取県,31384,日吉津村,3504,1629,1875,3439,65,1.89008,86.88,4.2,834.3,1240,1144,96,8.39161
31,鳥取県,31386,大山町,15405,7399,8006,16470,-1065,-6.4663,92.41819,189.83,81.2,5247,5300,-53,-1
31,鳥取県,31389,南部町,10319,4923,5396,10950,-631,-5.76256,91.23425,114.03,90.5,3547,3514,33,0.9391
31,鳥取県,31390,伯耆町,10710,5054,5656,11118,-408,-3.66972,89.35644,139.44,76.8,3641,3604,37,1.02664
31,鳥取県,31401,日南町,4199,1984,2215,4765,-566,-11.87828,89.57111,340.96,12.3,1790,1933,-143,-7.39783
31,鳥取県,31402,日野町,2909,1323,1586,3278,-369,-11.25686,83.4174,133.98,21.7,1215,1279,-64,-5.00391
31,鳥取県,31403,江府町,2679,1244,1435,3004,-325,-10.81891,86.6899,124.52,21.5,951,1010,-59,-5.84158
32,島根県,32201,松江市,203779,98577,105202,206230,-2451,-1.18848,93.70259,572.99,355.6,85388,83031,2357,2.8387
32,島根県,32202,浜田市,54622,27296,27326,58105,-3483,-5.99432,99.89021,690.68,79.1,24364,24498,-134,-0.54698
32,島根県,32203,出雲市,172887,83511,89376,171938,949,0.55194,93.43784,624.36,276.9,64145,60130,4015,6.6772
32,島根県,32204,益田市,45039,21366,23673,47718,-2679,-5.61423,90.25472,733.19,61.4,18857,19037,-180,-0.94553
32,島根県,32205,大田市,32866,15740,17126,35166,-2300,-6.54041,91.90704,435.34,75.5,13351,13613,-262,-1.92463
32,島根県,32206,安来市,37113,17760,19353,39528,-2415,-6.10959,91.76872,420.93,88.2,12841,12805,36,0.28114
32,島根県,32207,江津市,22979,10894,12085,24468,-1489,-6.0855,90.14481,268.24,85.7,9950,10123,-173,-1.70898
32,島根県,32209,雲南市,36024,17318,18706,39032,-3008,-7.7065,92.57992,553.18,65.1,12370,12527,-157,-1.25329
32,島根県,32343,奥出雲町,11859,5705,6154,13063,-1204,-9.21687,92.70393,368.01,32.2,4347,4464,-117,-2.62097
32,島根県,32386,飯南町,4577,2158,2419,5031,-454,-9.02405,89.21042,242.88,18.8,1757,1842,-85,-4.61455
32,島根県,32441,川本町,3251,1556,1695,3442,-191,-5.5491,91.79941,106.43,30.5,1408,1457,-49,-3.36307
32,島根県,32448,美郷町,4355,2081,2274,4900,-545,-11.12245,91.51275,282.92,15.4,1847,2010,-163,-8.10945
32,島根県,32449,邑南町,10166,4878,5288,11101,-935,-8.42266,92.2466,419.29,24.2,3980,4224,-244,-5.77652
32,島根県,32501,津和野町,6879,3220,3659,7653,-774,-10.11368,88.00219,307.03,22.4,3089,3300,-211,-6.39394
32,島根県,32505,吉賀町,6079,2942,3137,6374,-295,-4.62818,93.78387,336.5,18.1,2821,2810,11,0.39146
32,島根県,32525,海士町,2267,1111,1156,2353,-86,-3.65491,96.10727,33.44,67.8,1066,1057,9,0.85147
32,島根県,32526,西ノ島町,2788,1430,1358,3027,-239,-7.89561,105.30191,55.96,49.8,1427,1499,-72,-4.8032
32,島根県,32527,知夫村,634,323,311,615,19,3.08943,103.85852,13.7,46.3,348,331,17,5.13595
32,島根県,32528,隠岐の島町,13438,6528,6910,14608,-1170,-8.00931,94.47178,242.82,55.4,5961,6250,-289,-4.624
33,岡山県,33100,岡山市,725108,348694,376414,719474,5634,0.78307,92.63577,789.95,917.9,325945,309409,16536,5.34438
33,岡山県,33101,岡山市北区,314685,153498,161187,309484,5201,1.68054,95.22976,450.7,698.2,154500,146147,8353,5.71548
33,岡山県,33102,岡山市中区,149328,70154,79174,146232,3096,2.11718,88.60737,51.24,2914.3,65216,61528,3688,5.99402
33,岡山県,33103,岡山市東区,93179,44263,48916,95577,-2398,-2.50897,90.48777,160.53,580.4,37220,36198,1022,2.82336
33,岡山県,33104,岡山市南区,167916,80779,87137,168181,-265,-0.15757,92.70344,127.48,1317.2,69009,65536,3473,5.29938
33,岡山県,33202,倉敷市,474793,228312,246481,477118,-2325,-0.4873,92.62864,355.63,1335.1,198937,189847,9090,4.78807
33,岡山県,33203,津山市,99994,48021,51973,103746,-3752,-3.61652,92.39605,506.33,197.5,41137,40303,834,2.06932
33,岡山県,33204,玉野市,56582,27450,29132,60736,-4154,-6.83944,94.22628,103.58,546.3,24084,24764,-680,-2.74592
33,岡山県,33205,笠岡市,46134,21878,24256,50568,-4434,-8.76839,90.19624,136.24,338.6,18473,19189,-716,-3.7313
33,岡山県,33207,井原市,38406,18352,20054,41390,-2984,-7.20947,91.51292,243.54,157.7,14697,14914,-217,-1.45501
33,岡山県,33208,総社市,69106,33436,35670,66855,2251,3.36699,93.73703,211.9,326.1,26460,24863,1597,6.4232
33,岡山県,33209,高梁市,29101,14222,14879,32075,-2974,-9.27202,95.58438,546.99,53.2,12889,13481,-592,-4.39137
33,岡山県,33210,新見市,28113,13419,14694,30658,-2545,-8.30126,91.32299,793.29,35.4,11321,11648,-327,-2.80735
33,岡山県,33211,備前市,32345,15519,16826,35179,-2834,-8.05594,92.23226,258.14,125.3,13475,13878,-403,-2.90388
33,岡山県,33212,瀬戸内市,36054,17318,18736,36975,-921,-2.49087,92.43168,125.46,287.4,13887,13839,48,0.34685
33,岡山県,33213,赤磐市,42686,20468,22218,43214,-528,-1.22183,92.1235,209.36,203.9,16382,15730,652,4.14495
33,岡山県,33214,真庭市,42766,20397,22369,46124,-3358,-7.28037,91.18423,828.53,51.6,15821,16084,-263,-1.63517
33,岡山県,33215,美作市,25963,12448,13515,27977,-2014,-7.19877,92.10507,429.29,60.5,10749,10881,-132,-1.21312
33,岡山県,33216,浅口市,32810,15769,17041,34235,-1425,-4.16241,92.53565,66.46,493.7,12603,12463,140,1.12333
33,岡山県,33346,和気町,13634,6472,7162,14412,-778,-5.39828,90.36582,144.21,94.5,5221,5236,-15,-0.28648
33,岡山県,33423,早島町,12376,5933,6443,12154,222,1.82656,92.08443,7.62,1624.1,4507,4349,158,3.63302
33,岡山県,33445,里庄町,10960,5201,5759,10929,31,0.28365,90.31082,12.23,896.2,4129,4027,102,2.5329
33,岡山県,33461,矢掛町,13423,6411,7012,14201,-778,-5.47849,91.42898,90.62,148.1,4993,4955,38,0.7669
33,岡山県,33586,新庄村,816,380,436,866,-50,-5.77367,87.15596,67.11,12.2,331,330,1,0.30303
33,岡山県,33606,鏡野町,12068,5814,6254,12847,-779,-6.06367,92.9645,419.68,28.8,4639,4669,-30,-0.64254
33,岡山県,33622,勝央町,10894,5208,5686,11125,-231,-2.0764,91.59339,54.05,201.6,4101,4054,47,1.15935
33,岡山県,33623,奈義町,5582,2781,2801,5906,-324,-5.48595,99.28597,69.52,80.3,1942,1978,-36,-1.82002
33,岡山県,33643,西粟倉村,1400,652,748,1472,-72,-4.8913,87.16578,57.97,24.2,574,561,13,2.31729
33,岡山県,33663,久米南町,4534,2172,2362,4907,-373,-7.60139,91.95597,78.65,57.6,1792,1893,-101,-5.33545
33,岡山県,33666,美咲町,13065,6230,6835,14432,-1367,-9.47201,91.1485,232.17,56.3,5023,5258,-235,-4.46938
33,岡山県,33681,吉備中央町,10894,5274,5620,11950,-1056,-8.83682,93.84342,268.78,40.5,4245,4374,-129,-2.94925
34,広島県,34100,広島市,1201281,579466,621815,1194034,7247,0.60693,93.18945,906.69,1324.9,553993,531605,22388,4.2114
34,広島県,34101,広島市中区,142746,67667,75079,136640,6106,4.46868,90.12773,15.32,9317.6,81487,76889,4598,5.98005
34,広島県,34102,広島市東区,119397,56875,62522,120155,-758,-0.63085,90.96798,39.42,3028.8,52980,51790,1190,2.29774
34,広島県,34103,広島市南区,145889,71568,74321,142728,3161,2.2147,96.2958,26.46,5513.6,72075,68785,3290,4.78302
34,広島県,34104,広島市西区,190327,91103,99224,190929,-602,-0.3153,91.81549,35.61,5344.8,93627,90461,3166,3.49985
34,広島県,34105,広島市安佐南区,247118,120321,126797,242512,4606,1.89929,94.89262,117.03,2111.6,105924,99411,6513,6.55159
34,広島県,34106,広島市安佐北区,139040,65979,73061,145018,-5978,-4.12225,90.30673,353.33,393.5,57652,57151,501,0.87663
34,広島県,34107,広島市安芸区,77127,38286,38841,79353,-2226,-2.80519,98.5711,94.08,819.8,31572,31302,270,0.86256
34,広島県,34108,広島市佐伯区,139637,67667,71970,136699,2938,2.14925,94.02112,225.43,619.4,58676,55816,2860,5.12398
34,広島県,34202,呉市,214717,103801,110916,228552,-13835,-6.05333,93.58524,352.83,608.6,94580,97412,-2832,-2.90724
34,広島県,34203,竹原市,24017,11438,12579,26426,-2409,-9.11602,90.92933,118.23,203.1,10769,11204,-435,-3.88254
34,広島県,34204,三原市,90648,43175,47473,96194,-5546,-5.76543,90.94643,471.51,192.3,39087,39888,-801,-2.00812
34,広島県,34205,尾道市,131243,63468,67775,138626,-7383,-5.32584,93.64515,285.11,460.3,57571,57759,-188,-0.32549
34,広島県,34207,福山市,461268,224320,236948,464811,-3543,-0.76225,94.67056,518.14,890.2,191798,185555,6243,3.3645
34,広島県,34208,府中市,37677,18125,19552,40069,-2392,-5.9697,92.70151,195.75,192.5,14874,15039,-165,-1.09715
34,広島県,34209,三次市,50722,24224,26498,53615,-2893,-5.39588,91.41822,778.18,65.2,21409,21376,33,0.15438
34,広島県,34210,庄原市,33721,16050,17671,37000,-3279,-8.86216,90.82678,1246.49,27.1,13700,14455,-755,-5.22311
34,広島県,34211,大竹市,26326,12822,13504,27865,-1539,-5.52306,94.94964,78.66,334.7,11587,11749,-162,-1.37884
34,広島県,34212,東広島市,196755,99683,97072,192907,3848,1.99474,102.68976,635.16,309.8,90943,84847,6096,7.1847
34,広島県,34213,廿日市市,114253,54402,59851,114906,-653,-0.56829,90.89572,489.49,233.4,47642,46039,1603,3.48183
34,広島県,34214,安芸高田市,26463,12613,13850,29488,-3025,-10.25841,91.06859,537.71,49.2,11023,11657,-634,-5.43879
34,広島県,34215,江田島市,21937,11026,10911,24339,-2402,-9.86893,101.05398,100.72,217.8,10185,10741,-556,-5.17643
34,広島県,34302,府中町,51193,25002,26191,51053,140,0.27422,95.46027,10.41,4917.7,21673,21109,564,2.67185
34,広島県,34304,海田町,29646,14588,15058,28667,979,3.41508,96.87874,13.79,2149.8,12870,12246,624,5.09554
34,広島県,34307,熊野町,22844,10964,11880,23755,-911,-3.83498,92.28956,33.76,676.7,9420,9430,-10,-0.10604
34,広島県,34309,坂町,12592,5989,6603,12747,-155,-1.21597,90.7012,15.69,802.5,5228,5132,96,1.87062
34,広島県,34368,安芸太田町,5744,2676,3068,6472,-728,-11.24845,87.22295,341.89,16.8,2588,2781,-193,-6.93995
34,広島県,34369,北広島町,17778,8768,9010,18918,-1140,-6.02601,97.3141,646.2,27.5,7667,7728,-61,-0.78934
34,広島県,34431,大崎上島町,7161,3663,3498,7992,-831,-10.3979,104.71698,43.11,166.1,3436,3898,-462,-11.85223
34,広島県,34462,世羅町,15143,7158,7985,16337,-1194,-7.30856,89.64308,278.14,54.4,6105,6242,-137,-2.19481
34,広島県,34545,神石高原町,8259,3935,4324,9217,-958,-10.39384,91.0037,381.98,21.6,3336,3533,-197,-5.576
35,山口県,35201,下関市,255199,118683,136516,268517,-13318,-4.95983,86.93706,716.1,356.4,115441,116298,-857,-0.7369
35,山口県,35202,宇部市,162707,77795,84912,169429,-6722,-3.96744,91.61838,286.65,567.6,72564,73225,-661,-0.9027
35,山口県,35203,山口市,194110,92371,101739,197422,-3312,-1.67762,90.79212,1023.23,189.7,86623,84994,1629,1.91661
35,山口県,35204,萩市,44661,20617,24044,49560,-4899,-9.88499,85.74696,698.31,64,20330,21620,-1290,-5.9667
35,山口県,35206,防府市,114038,54952,59086,115942,-1904,-1.6422,93.00342,189.37,602.2,48707,47573,1134,2.38371
35,山口県,35207,下松市,55960,27415,28545,55812,148,0.26518,96.04134,89.36,626.2,24680,23757,923,3.88517
35,山口県,35208,岩国市,129226,60990,68236,136757,-7531,-5.50685,89.38097,873.72,147.9,57997,59080,-1083,-1.83311
35,山口県,35210,光市,49821,23700,26121,51369,-1548,-3.01349,90.7316,92.13,540.8,21392,20953,439,2.09517
35,山口県,35211,長門市,32537,15046,17491,35439,-2902,-8.18872,86.02138,357.31,91.1,14140,14666,-526,-3.58653
35,山口県,35212,柳井市,30821,14346,16475,32945,-2124,-6.44711,87.07739,140.05,220.1,13897,14170,-273,-1.92661
35,山口県,35213,美祢市,23267,10852,12415,26159,-2892,-11.05547,87.41039,472.64,49.2,9402,10095,-693,-6.86478
35,山口県,35215,周南市,137607,66670,70937,144842,-7235,-4.9951,93.9848,656.29,209.7,63082,61999,1083,1.7468
35,山口県,35216,山陽小野田市,60367,28638,31729,62671,-2304,-3.67634,90.25812,133.09,453.6,26082,25740,342,1.32867
35,山口県,35305,周防大島町,14810,6827,7983,17199,-2389,-13.89034,85.51923,138.09,107.2,7197,8038,-841,-10.4628
35,山口県,35321,和木町,6036,2945,3091,6285,-249,-3.96181,95.27661,10.58,570.5,2472,2593,-121,-4.66641
35,山口県,35341,上関町,2343,1083,1260,2803,-460,-16.41099,85.95238,34.69,67.5,1251,1459,-208,-14.25634
35,山口県,35343,田布施町,14498,6912,7586,15317,-819,-5.347,91.11521,50.42,287.5,5947,6131,-184,-3.00114
35,山口県,35344,平生町,11921,5555,6366,12798,-877,-6.85263,87.26045,34.59,344.6,4849,4951,-102,-2.06019
35,山口県,35502,阿武町,3058,1368,1690,3463,-405,-11.69506,80.94675,115.95,26.4,1365,1492,-127,-8.51206
36,徳島県,36201,徳島市,252364,120226,132138,258554,-6190,-2.39408,90.98518,191.39,1318.6,119346,115015,4331,3.7656
36,徳島県,36202,鳴門市,54664,25874,28790,59101,-4437,-7.50749,89.87148,135.66,402.9,22441,23234,-793,-3.4131
36,徳島県,36203,小松島市,36191,17467,18724,38755,-2564,-6.61592,93.28669,45.37,797.7,15141,15233,-92,-0.60395
36,徳島県,36204,阿南市,69519,33696,35823,73019,-3500,-4.79327,94.06247,279.25,248.9,27434,27193,241,0.88626
36,徳島県,36205,吉野川市,38783,18225,20558,41466,-2683,-6.47036,88.65162,144.14,269.1,15584,15714,-130,-0.82729
36,徳島県,36206,阿波市,34761,16482,18279,37202,-2441,-6.56148,90.16905,191.11,181.9,12985,13108,-123,-0.93836
36,徳島県,36207,美馬市,28094,13350,14744,30501,-2407,-7.89154,90.54531,367.14,76.5,11098,11440,-342,-2.98951
36,徳島県,36208,三好市,23608,11115,12493,26836,-3228,-12.02862,88.96982,721.42,32.7,10321,11311,-990,-8.75254
36,徳島県,36301,勝浦町,4833,2317,2516,5301,-468,-8.82852,92.09062,69.83,69.2,1847,1860,-13,-0.69892
36,徳島県,36302,上勝町,1383,652,731,1545,-162,-10.48544,89.19289,109.63,12.6,654,732,-78,-10.65574
36,徳島県,36321,佐那河内村,2060,999,1061,2289,-229,-10.00437,94.15646,42.28,48.7,771,793,-22,-2.77427
36,徳島県,36341,石井町,24859,11760,13099,25590,-731,-2.85658,89.77785,28.85,861.7,9626,9327,299,3.20575
36,徳島県,36342,神山町,4652,2183,2469,5300,-648,-12.22642,88.41636,173.3,26.8,2028,2156,-128,-5.93692
36,徳島県,36368,那賀町,7370,3519,3851,8402,-1032,-12.28279,91.37886,694.98,10.6,3187,3481,-294,-8.44585
36,徳島県,36383,牟岐町,3747,1734,2013,4259,-512,-12.0216,86.14009,56.62,66.2,1721,1871,-150,-8.0171
36,徳島県,36387,美波町,6217,2919,3298,7092,-875,-12.33785,88.50819,140.74,44.2,2669,2901,-232,-7.99724
36,徳島県,36388,海陽町,8363,3968,4395,9283,-920,-9.91059,90.28441,327.67,25.5,4022,4198,-176,-4.19247
36,徳島県,36401,松茂町,14582,7187,7395,15204,-622,-4.09103,97.18729,14.24,1024,5831,5881,-50,-0.8502
36,徳島県,36402,北島町,22777,10991,11786,22446,331,1.47465,93.25471,8.74,2606.1,9337,8824,513,5.81369
36,徳島県,36403,藍住町,35255,16864,18391,34626,629,1.81655,91.69703,16.27,2166.9,13967,13133,834,6.35041
36,徳島県,36404,板野町,13054,6265,6789,13358,-304,-2.27579,92.28163,36.22,360.4,5019,4930,89,1.80527
36,徳島県,36405,上板町,11269,5376,5893,12039,-770,-6.39588,91.22688,34.58,325.9,4253,4256,-3,-0.07049
36,徳島県,36468,つるぎ町,7723,3612,4111,8927,-1204,-13.48717,87.86183,194.84,39.6,3407,3838,-431,-11.22981
36,徳島県,36489,東みよし町,13576,6506,7070,14638,-1062,-7.25509,92.02263,122.48,110.8,5146,5325,-179,-3.3615
37,香川県,37201,高松市,417803,202089,215714,420748,-2945,-0.69994,93.68377,375.42,1112.9,187255,182047,5208,2.8608
37,香川県,37202,丸亀市,109589,53033,56556,110010,-421,-0.38269,93.77078,111.83,980,45633,43853,1780,4.05902
37,香川県,37203,坂出市,50683,24156,26527,53164,-2481,-4.66669,91.06194,92.49,548,21429,21361,68,0.31834
37,香川県,37204,善通寺市,31643,15730,15913,32927,-1284,-3.89954,98.85,39.93,792.5,13120,12977,143,1.10195
37,香川県,37205,観音寺市,57503,27589,29914,59409,-1906,-3.20827,92.22772,117.83,488,22880,21984,896,4.07569
37,香川県,37206,さぬき市,47043,22490,24553,50272,-3229,-6.42306,91.59777,158.63,296.6,19430,19752,-322,-1.63021
37,香川県,37207,東かがわ市,28300,13358,14942,31031,-2731,-8.80088,89.39901,152.83,185.2,11938,12441,-503,-4.04308
37,香川県,37208,三豊市,61917,29780,32137,65524,-3607,-5.50485,92.66577,222.7,278,23016,22761,255,1.12034
37,香川県,37322,土庄町,12856,6044,6812,14002,-1146,-8.18455,88.72578,74.38,172.8,5751,6061,-310,-5.11467
37,香川県,37324,小豆島町,13889,6627,7262,14862,-973,-6.5469,91.25585,95.59,145.3,6161,6411,-250,-3.89955
37,香川県,37341,三木町,26925,12940,13985,27684,-759,-2.74166,92.52771,75.78,355.3,10854,10667,187,1.75307
37,香川県,37364,直島町,3106,1644,1462,3139,-33,-1.05129,112.4487,14.22,218.4,1560,1519,41,2.69914
37,香川県,37386,宇多津町,18704,9183,9521,18952,-248,-1.30857,96.44995,8.1,2309.1,8700,8465,235,2.77614
37,香川県,37387,綾川町,22714,11005,11709,23610,-896,-3.795,93.98753,109.75,207,8822,8548,274,3.20543
37,香川県,37403,琴平町,8476,3941,4535,9186,-710,-7.72915,86.90187,8.47,1000.7,3678,3708,-30,-0.80906
37,香川県,37404,多度津町,22459,11378,11081,23366,-907,-3.88171,102.68026,24.39,920.8,9741,9551,190,1.98932
37,香川県,37406,まんのう町,17439,8351,9088,18377,-938,-5.10421,91.8904,194.45,89.7,6496,6445,51,0.79131
38,愛媛県,38201,松山市,511569,240313,271256,514865,-3296,-0.64017,88.59269,429.35,1191.5,240777,230509,10268,4.45449
38,愛媛県,38202,今治市,151756,71822,79934,158114,-6358,-4.02115,89.85163,419.21,362,68263,67105,1158,1.72565
38,愛媛県,38203,宇和島市,70820,33201,37619,77465,-6645,-8.57807,88.25593,468.19,151.3,31379,32732,-1353,-4.13357
38,愛媛県,38204,八幡浜市,31995,14970,17025,34951,-2956,-8.45755,87.92952,132.65,241.2,14413,14995,-582,-3.88129
38,愛媛県,38205,新居浜市,116005,56012,59993,119903,-3898,-3.25096,93.36423,234.5,494.7,51205,50653,552,1.08977
38,愛媛県,38206,西条市,104879,50682,54197,108174,-3295,-3.04602,93.5144,510.04,205.6,45170,44595,575,1.28938
38,愛媛県,38207,大洲市,40566,19427,21139,44086,-3520,-7.98439,91.90123,432.12,93.9,17442,18057,-615,-3.40588
38,愛媛県,38210,伊予市,35161,16391,18770,36827,-1666,-4.52385,87.32552,194.44,180.8,14124,14003,121,0.8641
38,愛媛県,38213,四国中央市,82849,40490,42359,87413,-4564,-5.22119,95.58771,421.24,196.7,35731,34999,732,2.09149
38,愛媛県,38214,西予市,35411,16637,18774,38919,-3508,-9.01359,88.61724,514.34,68.8,15447,16365,-918,-5.60953
38,愛媛県,38215,東温市,33917,16192,17725,34613,-696,-2.01081,91.3512,211.3,160.5,14391,13978,413,2.95464
38,愛媛県,38356,上島町,6510,3423,3087,7135,-625,-8.75964,110.88435,30.38,214.3,3215,3386,-171,-5.05021
38,愛媛県,38386,久万高原町,7413,3513,3900,8447,-1034,-12.24103,90.07692,583.69,12.7,3636,4052,-416,-10.26654
38,愛媛県,38401,松前町,29646,13911,15735,30064,-418,-1.39037,88.40801,20.41,1452.5,11884,11525,359,3.11497
38,愛媛県,38402,砥部町,20491,9518,10973,21239,-748,-3.52182,86.74018,101.59,201.7,8469,8356,113,1.35232
38,愛媛県,38422,内子町,15333,7304,8029,16742,-1409,-8.41596,90.97023,299.43,51.2,6258,6475,-217,-3.35135
38,愛媛県,38442,伊方町,8401,4039,4362,9626,-1225,-12.72595,92.59514,93.98,89.4,4076,4488,-412,-9.18004
38,愛媛県,38484,松野町,3681,1729,1952,4072,-391,-9.60216,88.57582,98.45,37.4,1603,1675,-72,-4.29851
38,愛媛県,38488,鬼北町,9685,4461,5224,10705,-1020,-9.52826,85.39433,241.88,40,4345,4614,-269,-5.83008
38,愛媛県,38506,愛南町,19606,9185,10421,21902,-2296,-10.48306,88.13933,238.99,82,8887,9410,-523,-5.55792
39,高知県,39201,高知市,326814,152482,174332,337190,-10376,-3.0772,87.46644,309,1057.7,154006,153594,412,0.26824
39,高知県,39202,室戸市,11744,5656,6088,13524,-1780,-13.16179,92.90407,248.22,47.3,5934,6512,-578,-8.87592
39,高知県,39203,安芸市,16258,7749,8509,17577,-1319,-7.50412,91.06828,317.21,51.3,7302,7604,-302,-3.97159
39,高知県,39204,南国市,46702,22139,24563,47982,-1280,-2.66767,90.1315,125.3,372.7,19726,19481,245,1.25764
39,高知県,39205,土佐市,25762,12369,13393,27038,-1276,-4.71928,92.35421,91.5,281.6,10258,10255,3,0.02925
39,高知県,39206,須崎市,20603,10068,10535,22606,-2003,-8.86048,95.56716,135.34,152.2,8650,9121,-471,-5.16391
39,高知県,39208,宿毛市,19044,8924,10120,20907,-1863,-8.91089,88.18182,286.2,66.5,8568,8925,-357,-4
39,高知県,39209,土佐清水市,12388,5834,6554,13778,-1390,-10.08855,89.01434,266.34,46.5,6150,6586,-436,-6.6201
39,高知県,39210,四万十市,32719,15455,17264,34313,-1594,-4.64547,89.52155,632.29,51.7,14839,14771,68,0.46036
39,高知県,39211,香南市,32229,15530,16699,32961,-732,-2.22081,92.99958,126.46,254.9,13138,12953,185,1.42824
39,高知県,39212,香美市,26556,12851,13705,27513,-957,-3.47836,93.7687,537.86,49.4,11943,11979,-36,-0.30053
39,高知県,39301,東洋町,2193,1085,1108,2584,-391,-15.13158,97.92419,74.02,29.6,1236,1382,-146,-10.5644
39,高知県,39302,奈半利町,3036,1405,1631,3326,-290,-8.71918,86.14347,28.37,107,1408,1474,-66,-4.47761
39,高知県,39303,田野町,2498,1171,1327,2733,-235,-8.59861,88.24416,6.53,382.5,1168,1188,-20,-1.6835
39,高知県,39304,安田町,2373,1144,1229,2631,-258,-9.80616,93.08381,52.36,45.3,1067,1146,-79,-6.89354
39,高知県,39305,北川村,1146,552,594,1294,-148,-11.4374,92.92929,196.73,5.8,549,582,-33,-5.6701
39,高知県,39306,馬路村,747,359,388,823,-76,-9.23451,92.52577,165.48,4.5,377,391,-14,-3.58056
39,高知県,39307,芸西村,3696,1720,1976,3858,-162,-4.19907,87.04453,39.6,93.3,1511,1488,23,1.5457
39,高知県,39341,本山町,3264,1510,1754,3573,-309,-8.64819,86.08894,134.22,24.3,1502,1688,-186,-11.01896
39,高知県,39344,大豊町,3256,1543,1713,3962,-706,-17.81928,90.07589,315.06,10.3,1790,2050,-260,-12.68293
39,高知県,39363,土佐町,3750,1780,1970,3997,-247,-6.17963,90.35533,212.13,17.7,1617,1734,-117,-6.7474
39,高知県,39364,大川村,366,189,177,396,-30,-7.57576,106.77966,95.27,3.8,199,210,-11,-5.2381
39,高知県,39386,いの町,21394,10208,11186,22767,-1373,-6.03066,91.25693,470.97,45.4,9120,9198,-78,-0.84801
39,高知県,39387,仁淀川町,4824,2302,2522,5551,-727,-13.09674,91.27676,333,14.5,2454,2778,-324,-11.66307
39,高知県,39401,中土佐町,6002,2784,3218,6840,-838,-12.25146,86.51336,193.21,31.1,2701,2916,-215,-7.37311
39,高知県,39402,佐川町,12336,5753,6583,13114,-778,-5.93259,87.39177,100.8,122.4,5131,5237,-106,-2.02406
39,高知県,39403,越知町,5191,2390,2801,5795,-604,-10.42278,85.32667,111.95,46.4,2334,2518,-184,-7.30739
39,高知県,39405,檮原町,3308,1612,1696,3608,-300,-8.31486,95.04717,236.45,14,1513,1560,-47,-3.01282
39,高知県,39410,日高村,4826,2295,2531,5030,-204,-4.05567,90.67562,44.85,107.6,1976,1968,8,0.4065
39,高知県,39411,津野町,5297,2516,2781,5794,-497,-8.57784,90.47105,197.85,26.8,2204,2297,-93,-4.04876
39,高知県,39412,四万十町,15596,7436,8160,17325,-1729,-9.9798,91.12745,642.28,24.3,7150,7454,-304,-4.07835
39,高知県,39424,大月町,4432,2127,2305,5095,-663,-13.01276,92.27766,102.94,43.1,2198,2369,-171,-7.21824
39,高知県,39427,三原村,1440,691,749,1574,-134,-8.51334,92.25634,85.37,16.9,658,703,-45,-6.40114
39,高知県,39428,黒潮町,10275,4950,5325,11217,-942,-8.39797,92.95775,188.46,54.5,4496,4899,-403,-8.22617
40,福岡県,40100,北九州市,939622,443258,496364,961286,-21664,-2.25365,89.301,491.69,1911,435350,426325,9025,2.11693
40,福岡県,40101,北九州市門司区,93899,43041,50858,99637,-5738,-5.7589,84.62975,73.67,1274.6,43235,43082,153,0.35514
40,福岡県,40103,北九州市若松区,80597,38318,42279,82877,-2280,-2.75106,90.63128,71.31,1130.2,33869,33702,167,0.49552
40,福岡県,40105,北九州市戸畑区,57538,28039,29499,59116,-1578,-2.66933,95.05068,16.61,3464.1,28443,27797,646,2.32399
40,福岡県,40106,北九州市小倉北区,183517,86089,97428,181878,1639,0.90115,88.36166,39.23,4678,95956,91253,4703,5.1538
40,福岡県,40107,北九州市小倉南区,209141,99623,109518,212850,-3709,-1.74254,90.96496,171.48,1219.6,91046,88497,2549,2.88032
40,福岡県,40108,北九州市八幡東区,64858,30396,34462,68844,-3986,-5.7899,88.2015,36.26,1788.7,30328,31442,-1114,-3.54303
40,福岡県,40109,北九州市八幡西区,250072,117752,132320,256084,-6012,-2.34767,88.99033,83.13,3008.2,112473,110552,1921,1.73764
40,福岡県,40130,福岡市,1613361,760972,852389,1538681,74680,4.85351,89.2752,343.46,4697.4,827083,764820,62263,8.14087
40,福岡県,40131,福岡市東区,322683,156742,165941,306015,16668,5.44679,94.45646,69.45,4646.3,155581,141682,13899,9.81
40,福岡県,40132,福岡市博多区,252153,121596,130557,228441,23712,10.37992,93.13633,31.62,7974.5,153462,138832,14630,10.53792
40,福岡県,40133,福岡市中央区,205610,92431,113179,192688,12922,6.70618,81.66798,15.39,13360,127018,116186,10832,9.32298
40,福岡県,40134,福岡市南区,265753,122824,142929,255797,9956,3.89215,85.93358,30.98,8578.2,128536,119637,8899,7.43833
40,福岡県,40135,福岡市西区,212729,100882,111847,206868,5861,2.83321,90.19643,84.15,2528,94607,88142,6465,7.33476
40,福岡県,40136,福岡市城南区,132947,62309,70638,130995,1952,1.49013,88.2089,15.99,8314.4,67302,64606,2696,4.17299
40,福岡県,40137,福岡市早良区,221486,104188,117298,217877,3609,1.65644,88.82334,95.87,2310.3,100577,95735,4842,5.05771
40,福岡県,40202,大牟田市,111379,51239,60140,117360,-5981,-5.09628,85.19953,81.45,1367.5,49175,49398,-223,-0.45144
40,福岡県,40203,久留米市,303496,144486,159010,304552,-1056,-0.34674,90.86598,229.96,1319.8,128306,121913,6393,5.2439
40,福岡県,40204,直方市,56287,26403,29884,57146,-859,-1.50317,88.35163,61.76,911.4,23614,23281,333,1.43035
40,福岡県,40205,飯塚市,126486,60195,66291,129146,-2660,-2.05968,90.80418,213.96,591.2,55536,54732,804,1.46898
40,福岡県,40206,田川市,46235,21070,25165,48441,-2206,-4.55399,83.7274,54.55,847.6,20649,20955,-306,-1.46027
40,福岡県,40207,柳川市,64540,30444,34096,67777,-3237,-4.77596,89.28907,77.15,836.6,23897,23453,444,1.89315
40,福岡県,40210,八女市,60653,28468,32185,64408,-3755,-5.83002,88.45114,482.44,125.7,22252,22109,143,0.6468
40,福岡県,40211,筑後市,48867,23403,25464,48339,528,1.09229,91.90622,41.78,1169.6,18746,17379,1367,7.86582
40,福岡県,40212,大川市,33010,15430,17580,34838,-1828,-5.24714,87.77019,33.62,981.9,12889,12709,180,1.41632
40,福岡県,40213,行橋市,71501,34128,37373,70586,915,1.29629,91.31726,70.06,1020.6,30491,28648,1843,6.43326
40,福岡県,40214,豊前市,24411,11384,13027,25940,-1529,-5.89437,87.38773,111.01,219.9,9893,10070,-177,-1.7577
40,福岡県,40215,中間市,40373,18956,21417,41796,-1423,-3.40463,88.50913,15.96,2529.6,17309,17414,-105,-0.60296
40,福岡県,40216,小郡市,59408,27805,31603,57983,1425,2.45762,87.98215,45.51,1305.4,22775,20964,1811,8.63862
40,福岡県,40217,筑紫野市,103374,49305,54069,101081,2293,2.26848,91.18904,87.73,1178.3,41840,39350,2490,6.32783
40,福岡県,40218,春日市,111097,53130,57967,110743,354,0.31966,91.6556,14.15,7851.4,46379,43720,2659,6.08188
40,福岡県,40219,大野城市,102172,48884,53288,99525,2647,2.65963,91.73548,26.89,3799.6,42702,39885,2817,7.06281
40,福岡県,40220,宗像市,97158,46142,51016,96516,642,0.66517,90.44613,119.94,810.1,40867,38995,1872,4.80062
40,福岡県,40221,太宰府市,73286,34773,38513,72168,1118,1.54916,90.28899,29.6,2475.9,31001,29107,1894,6.50703
40,福岡県,40223,古賀市,58831,27908,30923,57959,872,1.50451,90.24998,42.07,1398.4,23708,22320,1388,6.21864
40,福岡県,40224,福津市,67141,31343,35798,58781,8360,14.22228,87.55517,52.76,1272.6,26468,22272,4196,18.8398
40,福岡県,40225,うきは市,28012,13153,14859,29509,-1497,-5.07303,88.51874,117.46,238.5,10073,9940,133,1.33803
40,福岡県,40226,宮若市,26327,12401,13926,28112,-1785,-6.3496,89.04926,139.99,188.1,10373,10737,-364,-3.39015
40,福岡県,40227,嘉麻市,35515,16400,19115,38743,-3228,-8.33183,85.79649,135.11,262.9,15039,15637,-598,-3.82426
40,福岡県,40228,朝倉市,50342,23557,26785,52444,-2102,-4.00808,87.94848,246.71,204.1,19341,19088,253,1.32544
40,福岡県,40229,みやま市,35908,16681,19227,38139,-2231,-5.84966,86.7582,105.21,341.3,13063,12941,122,0.94274
40,福岡県,40230,糸島市,98945,46980,51965,96475,2470,2.56025,90.407,215.7,458.7,37691,34739,2952,8.49765
40,福岡県,40231,那珂川市,50142,24188,25954,50004,138,0.27598,93.19565,74.95,669,19010,18291,719,3.93089
40,福岡県,40341,宇美町,37701,18966,18735,37927,-226,-0.59588,101.23299,30.21,1248,14080,13119,961,7.32525
40,福岡県,40342,篠栗町,31228,15011,16217,31210,18,0.05767,92.56336,38.93,802.2,12207,11539,668,5.78906
40,福岡県,40343,志免町,46390,22312,24078,45256,1134,2.50575,92.6655,8.69,5338.3,18993,17591,1402,7.96998
40,福岡県,40344,須恵町,28646,13764,14882,27263,1383,5.07281,92.48757,16.31,1756.3,10912,9919,993,10.01109
40,福岡県,40345,新宮町,32945,15898,17047,30344,2601,8.57171,93.25981,18.93,1740.4,12406,10946,1460,13.33821
40,福岡県,40348,久山町,9079,4281,4798,8225,854,10.38298,89.22468,37.44,242.5,3282,2825,457,16.17699
40,福岡県,40349,粕屋町,48216,23849,24367,45360,2856,6.2963,97.87417,14.13,3412.3,19828,18005,1823,10.12497
40,福岡県,40381,芦屋町,13561,6637,6924,14208,-647,-4.55377,95.855,11.6,1169.1,5596,5573,23,0.4127
40,福岡県,40382,水巻町,28138,13074,15064,28997,-859,-2.96238,86.7897,11.01,2555.7,12228,12220,8,0.06547
40,福岡県,40383,岡垣町,31027,14486,16541,31580,-553,-1.75111,87.57633,48.64,637.9,12154,11784,370,3.13985
40,福岡県,40384,遠賀町,18736,8795,9941,18877,-141,-0.74694,88.47198,22.15,845.9,7550,7269,281,3.86573
40,福岡県,40401,小竹町,7152,3406,3746,7810,-658,-8.4251,90.92365,14.28,500.8,3184,3331,-147,-4.41309
40,福岡県,40402,鞍手町,15094,7076,8018,16007,-913,-5.70375,88.25143,35.6,424,6259,6393,-134,-2.09604
40,福岡県,40421,桂川町,12895,6024,6871,13496,-601,-4.45317,87.67283,20.14,640.3,5129,5226,-97,-1.8561
40,福岡県,40447,筑前町,29615,14061,15554,29306,309,1.05439,90.40118,67.1,441.4,10625,9767,858,8.78468
40,福岡県,40448,東峰村,1904,871,1033,2174,-270,-12.4195,84.31752,51.97,36.6,693,742,-49,-6.60377
40,福岡県,40503,大刀洗町,15529,7438,8091,15138,391,2.5829,91.9293,22.84,679.9,5516,5008,508,10.14377
40,福岡県,40522,大木町,13824,6544,7280,14176,-352,-2.48307,89.89011,18.44,749.7,4768,4556,212,4.6532
40,福岡県,40544,広川町,19988,9587,10401,20183,-195,-0.96616,92.17383,37.94,526.8,7449,7007,442,6.30798
40,福岡県,40601,香春町,10198,4738,5460,10861,-663,-6.10441,86.77656,44.5,229.2,4330,4429,-99,-2.23527
40,福岡県,40602,添田町,8805,4128,4677,9924,-1119,-11.2757,88.26171,132.2,66.6,3726,4029,-303,-7.52048
40,福岡県,40604,糸田町,8414,3843,4571,9020,-606,-6.7184,84.07351,8.04,1046.5,3637,3814,-177,-4.6408
40,福岡県,40605,川崎町,15190,6920,8270,16789,-1599,-9.52409,83.67594,36.14,420.3,6917,7349,-432,-5.87835
40,福岡県,40608,大任町,5013,2258,2755,5176,-163,-3.14915,81.96007,14.26,351.5,2040,2052,-12,-0.5848
40,福岡県,40609,赤村,2776,1295,1481,3022,-246,-8.1403,87.44092,31.98,86.8,1072,1127,-55,-4.88021
40,福岡県,40610,福智町,21424,9990,11434,22871,-1447,-6.32679,87.371,42.06,509.4,8510,8727,-217,-2.48654
40,福岡県,40621,苅田町,37691,19641,18050,34963,2728,7.80253,108.8144,49.24,765.5,17627,15341,2286,14.90125
40,福岡県,40625,みやこ町,18838,8806,10032,20243,-1405,-6.94067,87.77911,151.34,124.5,7347,7527,-180,-2.39139
40,福岡県,40642,吉富町,6539,3071,3468,6627,-88,-1.3279,88.55248,5.72,1143.2,2669,2589,80,3.09
40,福岡県,40646,上毛町,7254,3453,3801,7458,-204,-2.73532,90.84451,62.44,116.2,2796,2791,5,0.17915
40,福岡県,40647,築上町,17202,8275,8927,18587,-1385,-7.45144,92.69631,119.61,143.8,6961,7250,-289,-3.98621
41,佐賀県,41201,佐賀市,233466,110205,123261,236372,-2906,-1.22942,89.40784,431.84,540.6,96697,93306,3391,3.63428
41,佐賀県,41202,唐津市,117431,55029,62402,122785,-5354,-4.36047,88.18467,487.6,240.8,44149,43872,277,0.63138
41,佐賀県,41203,鳥栖市,74258,35526,38732,72902,1356,1.86003,91.72261,71.72,1035.4,29694,27630,2064,7.47014
41,佐賀県,41204,多久市,18304,8554,9750,19749,-1445,-7.31683,87.73333,96.96,188.8,6762,6847,-85,-1.24142
41,佐賀県,41205,伊万里市,52651,25445,27206,55238,-2587,-4.68337,93.52716,255.25,206.3,19970,19698,272,1.38085
41,佐賀県,41206,武雄市,47962,22730,25232,49062,-1100,-2.24206,90.08402,195.4,245.5,17585,16932,653,3.8566
41,佐賀県,41207,鹿島市,27915,13140,14775,29684,-1769,-5.95944,88.93401,112.12,249,10029,10124,-95,-0.93836
41,佐賀県,41208,小城市,43976,20772,23204,44259,-283,-0.63942,89.51905,95.81,459,15894,14769,1125,7.61731
41,佐賀県,41209,嬉野市,25867,11997,13870,27336,-1469,-5.37387,86.49603,126.41,204.6,9151,9214,-63,-0.68374
41,佐賀県,41210,神埼市,31046,14884,16162,31842,-796,-2.49984,92.09256,125.13,248.1,11436,10913,523,4.79245
41,佐賀県,41327,吉野ヶ里町,16330,7985,8345,16411,-81,-0.49357,95.68604,43.99,371.2,6079,5891,188,3.19131
41,佐賀県,41341,基山町,17256,8177,9079,17501,-245,-1.39992,90.06499,22.15,779.1,6744,6321,423,6.69198
41,佐賀県,41345,上峰町,9295,4454,4841,9283,12,0.12927,92.00578,12.8,726.2,3569,3260,309,9.47853
41,佐賀県,41346,みやき町,25531,12179,13352,25278,253,1.00087,91.2148,51.92,491.7,9224,8638,586,6.78398
41,佐賀県,41387,玄海町,5609,3067,2542,5902,-293,-4.96442,120.65303,35.92,156.2,2231,1918,313,16.31908
41,佐賀県,41401,有田町,19028,8786,10242,20148,-1120,-5.55886,85.78403,65.85,289,6975,6900,75,1.08696
41,佐賀県,41423,大町町,6305,2903,3402,6777,-472,-6.96473,85.33216,11.5,548.3,2453,2560,-107,-4.17969
41,佐賀県,41424,江北町,9573,4463,5110,9583,-10,-0.10435,87.33855,24.49,390.9,3426,3225,201,6.23256
41,佐賀県,41425,白石町,22084,10359,11725,23941,-1857,-7.75657,88.34968,99.56,221.8,7259,7253,6,0.08272
41,佐賀県,41441,太良町,8126,3844,4282,8779,-653,-7.4382,89.77113,74.3,109.4,2784,2838,-54,-1.90275
42,長崎県,42201,長崎市,409305,188491,220814,429508,-20203,-4.70375,85.36189,405.86,1008.5,187229,189419,-2190,-1.15617
42,長崎県,42202,佐世保市,243387,115137,128250,255439,-12052,-4.71815,89.77544,426.01,571.3,104106,105011,-905,-0.86181
42,長崎県,42203,島原市,43360,20158,23202,45436,-2076,-4.56906,86.88044,82.96,522.7,17077,17068,9,0.05273
42,長崎県,42204,諫早市,133957,63559,70398,138078,-4121,-2.98454,90.28524,341.79,391.9,53587,51897,1690,3.25645
42,長崎県,42205,大村市,95452,45454,49998,92757,2695,2.90544,90.91164,126.73,753.2,38971,36070,2901,8.04269
42,長崎県,42207,平戸市,29375,13774,15601,31920,-2545,-7.97306,88.28921,235.12,124.9,11973,12421,-448,-3.60679
42,長崎県,42208,松浦市,21284,10270,11014,23309,-2025,-8.68763,93.24496,130.55,163,8774,8994,-220,-2.44608
42,長崎県,42209,対馬市,28511,14067,14444,31457,-2946,-9.36517,97.38992,707.42,40.3,12684,13393,-709,-5.29381
42,長崎県,42210,壱岐市,24974,11836,13138,27103,-2129,-7.85522,90.08982,139.42,179.1,9715,10002,-287,-2.86943
42,長崎県,42211,五島市,34400,16141,18259,37327,-2927,-7.84151,88.40024,420.12,81.9,16549,17425,-876,-5.02726
42,長崎県,42212,西海市,26296,13121,13175,28691,-2395,-8.34757,99.59013,241.6,108.8,11172,11494,-322,-2.80146
42,長崎県,42213,雲仙市,41131,19380,21751,44115,-2984,-6.76414,89.09935,214.31,191.9,15145,15376,-231,-1.50234
42,長崎県,42214,南島原市,42360,19593,22767,46535,-4175,-8.97174,86.05877,170.13,249,16051,16664,-613,-3.67859
42,長崎県,42307,長与町,40800,19198,21602,42548,-1748,-4.1083,88.8714,28.73,1420.1,16061,16237,-176,-1.08394
42,長崎県,42308,時津町,29356,14112,15244,29804,-448,-1.50315,92.57413,20.94,1401.9,11429,11137,292,2.62189
42,長崎県,42321,東彼杵町,7734,3684,4050,8298,-564,-6.79682,90.96296,74.29,104.1,2719,2744,-25,-0.91108
42,長崎県,42322,川棚町,13394,6302,7092,14067,-673,-4.78425,88.86069,37.25,359.6,5162,5103,59,1.15618
42,長崎県,42323,波佐見町,14302,6762,7540,14891,-589,-3.95541,89.6817,56,255.4,5025,4957,68,1.3718
42,長崎県,42383,小値賀町,2291,1056,1235,2560,-269,-10.50781,85.50607,25.5,89.8,1127,1210,-83,-6.8595
42,長崎県,42391,佐々町,13923,6591,7332,13626,297,2.17966,89.89362,32.26,431.6,5434,5102,332,6.50725
42,長崎県,42411,新上五島町,17511,8241,9270,19718,-2207,-11.19282,88.89968,213.99,81.8,8382,8996,-614,-6.82526
43,熊本県,43100,熊本市,738744,349086,389658,740822,-2078,-0.2805,89.58779,390.32,1892.7,326737,315456,11281,3.57609
43,熊本県,43101,熊本市中央区,187475,88617,98858,186300,1175,0.6307,89.6407,25.45,7366.4,99856,95754,4102,4.28389
43,熊本県,43102,熊本市東区,189389,89661,99728,190451,-1062,-0.55762,89.90554,50.19,3773.4,80321,78406,1915,2.44242
43,熊本県,43103,熊本市西区,91143,42776,48367,93171,-2028,-2.17664,88.44047,89.33,1020.3,39804,38944,860,2.2083
43,熊本県,43104,熊本市南区,130914,61638,69276,127769,3145,2.46147,88.97454,110.01,1190,49916,47144,2772,5.87986
43,熊本県,43105,熊本市北区,139823,66394,73429,143131,-3308,-2.31117,90.41932,115.34,1212.3,56840,55208,1632,2.95609
43,熊本県,43202,八代市,123146,57320,65826,127472,-4326,-3.39369,87.07805,681.36,180.7,49052,47972,1080,2.25131
43,熊本県,43203,人吉市,31334,14363,16971,33880,-2546,-7.51476,84.63261,210.55,148.8,13262,13849,-587,-4.23857
43,熊本県,43204,荒尾市,50878,23908,26970,53407,-2529,-4.73533,88.64664,57.37,886.8,20756,20910,-154,-0.73649
43,熊本県,43205,水俣市,23580,10913,12667,25411,-1831,-7.20554,86.153,163.29,144.4,10115,10639,-524,-4.92527
43,熊本県,43206,玉名市,64367,30417,33950,66782,-2415,-3.61624,89.59352,152.6,421.8,25255,24474,781,3.19114
43,熊本県,43208,山鹿市,49082,23006,26076,52264,-3182,-6.08832,88.22672,299.69,163.8,19074,19145,-71,-0.37085
43,熊本県,43210,菊池市,46473,22078,24395,48167,-1694,-3.51693,90.50215,276.85,167.9,17576,16949,627,3.69933
43,熊本県,43211,宇土市,36192,17287,18905,37026,-834,-2.25247,91.44142,74.3,487.1,13475,13285,190,1.43018
43,熊本県,43212,上天草市,24584,11510,13074,27006,-2422,-8.96838,88.03733,126.94,193.7,10016,10477,-461,-4.40011
43,熊本県,43213,宇城市,57075,26988,30087,59756,-2681,-4.48658,89.69987,188.61,302.6,21524,21432,92,0.42926
43,熊本県,43214,阿蘇市,24966,11772,13194,27018,-2052,-7.59494,89.22237,376.3,66.3,9970,10078,-108,-1.07164
43,熊本県,43215,天草市,75826,35418,40408,82739,-6913,-8.35519,87.65096,683.82,110.9,31855,33224,-1369,-4.12052
43,熊本県,43216,合志市,61829,29727,32102,58370,3459,5.92599,92.60171,53.19,1162.4,22255,20560,1695,8.24416
43,熊本県,43348,美里町,9406,4367,5039,10333,-927,-8.97126,86.66402,144,65.3,3433,3611,-178,-4.92938
43,熊本県,43364,玉東町,5047,2401,2646,5265,-218,-4.14055,90.74074,24.33,207.4,1813,1825,-12,-0.65753
43,熊本県,43367,南関町,8968,4278,4690,9786,-818,-8.35888,91.21535,68.92,130.1,3414,3560,-146,-4.10112
43,熊本県,43368,長洲町,15383,7672,7711,15889,-506,-3.18459,99.49423,19.44,791.3,6433,6139,294,4.78905
43,熊本県,43369,和水町,9347,4402,4945,10191,-844,-8.28182,89.01921,98.78,94.6,3415,3512,-97,-2.76196
43,熊本県,43403,大津町,35212,17457,17755,33452,1760,5.26127,98.3216,99.1,355.3,14147,12705,1442,11.34986
43,熊本県,43404,菊陽町,43376,21237,22139,40984,2392,5.83642,95.92574,37.46,1157.9,17779,15950,1829,11.46708
43,熊本県,43423,南小国町,3737,1773,1964,4048,-311,-7.68281,90.27495,115.9,32.2,1601,1642,-41,-2.49695
43,熊本県,43424,小国町,6599,3140,3459,7187,-588,-8.18144,90.77768,136.94,48.2,2665,2805,-140,-4.99109
43,熊本県,43425,産山村,1384,714,670,1510,-126,-8.34437,106.56716,60.81,22.8,516,526,-10,-1.90114
43,熊本県,43428,高森町,5787,2782,3005,6325,-538,-8.50593,92.57903,175.06,33.1,2393,2463,-70,-2.84206
43,熊本県,43432,西原村,6430,3110,3320,6802,-372,-5.46898,93.6747,77.22,83.3,2348,2341,7,0.29902
43,熊本県,43433,南阿蘇村,9843,4794,5049,11503,-1660,-14.43102,94.94949,137.32,71.7,4029,4676,-647,-13.83661
43,熊本県,43441,御船町,16314,7764,8550,17237,-923,-5.35476,90.80702,99.03,164.7,6192,6317,-125,-1.97879
43,熊本県,43442,嘉島町,9553,4582,4971,9054,499,5.51138,92.17461,16.65,573.8,3476,3170,306,9.653
43,熊本県,43443,益城町,32529,15601,16928,33611,-1082,-3.21918,92.16092,65.68,495.3,11728,11477,251,2.18698
43,熊本県,43444,甲佐町,10139,4815,5324,10717,-578,-5.3933,90.43952,57.93,175,3671,3710,-39,-1.05121
43,熊本県,43447,山都町,13521,6438,7083,15149,-1628,-10.74658,90.89369,544.67,24.8,5269,5594,-325,-5.8098
43,熊本県,43468,氷川町,11101,5082,6019,11994,-893,-7.44539,84.43263,33.36,332.8,3932,3878,54,1.39247
43,熊本県,43482,芦北町,15688,7372,8316,17661,-1973,-11.17151,88.64839,234.01,67,5997,6481,-484,-7.46798
43,熊本県,43484,津奈木町,4255,1991,2264,4673,-418,-8.945,87.9417,34.08,124.9,1687,1744,-57,-3.26835
43,熊本県,43501,錦町,10292,4892,5400,10766,-474,-4.40275,90.59259,85.04,121,3729,3641,88,2.41692
43,熊本県,43505,多良木町,9082,4266,4816,9791,-709,-7.24134,88.57973,165.86,54.8,3445,3537,-92,-2.60107
43,熊本県,43506,湯前町,3627,1700,1927,3985,-358,-8.98369,88.22003,48.37,75,1401,1479,-78,-5.27383
43,熊本県,43507,水上村,2033,939,1094,2232,-199,-8.91577,85.83181,190.96,10.6,787,822,-35,-4.25791
43,熊本県,43510,相良村,4103,1946,2157,4468,-365,-8.1692,90.2179,94.54,43.4,1473,1504,-31,-2.06117
43,熊本県,43511,五木村,932,452,480,1055,-123,-11.65877,94.16667,252.92,3.7,424,461,-37,-8.02603
43,熊本県,43512,山江村,3239,1497,1742,3422,-183,-5.34775,85.93571,121.19,26.7,1131,1149,-18,-1.56658
43,熊本県,43513,球磨村,2438,1173,1265,3698,-1260,-34.07247,92.72727,207.58,11.7,980,1368,-388,-28.36257
43,熊本県,43514,あさぎり町,14685,6780,7905,15523,-838,-5.39844,85.7685,159.56,92,5348,5298,50,0.94375
43,熊本県,43531,苓北町,7085,3389,3696,7739,-654,-8.4507,91.69372,67.58,104.8,2786,2895,-109,-3.76511
44,大分県,44201,大分市,475852,228440,247412,478146,-2294,-0.47977,92.33182,502.39,947.2,209210,203515,5695,2.79832
44,大分県,44202,別府市,115416,52432,62984,122138,-6722,-5.50361,83.24654,125.34,920.8,54080,55624,-1544,-2.77578
44,大分県,44203,中津市,82911,40309,42602,83965,-1054,-1.25528,94.61762,491.44,168.7,37519,35785,1734,4.84561
44,大分県,44204,日田市,62697,29688,33009,66523,-3826,-5.75139,89.93911,666.03,94.1,25105,25238,-133,-0.52698
44,大分県,44205,佐伯市,66908,30896,36012,72211,-5303,-7.34376,85.79362,903.14,74.1,28690,29574,-884,-2.98911
44,大分県,44206,臼杵市,36176,17093,19083,38748,-2572,-6.63776,89.57187,291.2,124.2,14745,15077,-332,-2.20203
44,大分県,44207,津久見市,16109,7504,8605,17969,-1860,-10.35116,87.20511,79.48,202.7,6993,7518,-525,-6.98324
44,大分県,44208,竹田市,20357,9504,10853,22332,-1975,-8.84381,87.57026,477.53,42.6,8680,9100,-420,-4.61538
44,大分県,44209,豊後高田市,22142,10504,11638,22853,-711,-3.11119,90.25606,206.24,107.4,9313,9572,-259,-2.70581
44,大分県,44210,杵築市,28025,13437,14588,30185,-2160,-7.15587,92.10995,280.08,100.1,11998,12084,-86,-0.71168
44,大分県,44211,宇佐市,52810,24884,27926,56258,-3448,-6.12891,89.10693,439.05,120.3,21922,22524,-602,-2.6727
44,大分県,44212,豊後大野市,33741,15709,18032,36584,-2843,-7.77116,87.11735,603.14,55.9,13791,14326,-535,-3.73447
44,大分県,44213,由布市,32787,15595,17192,34262,-1475,-4.30506,90.7108,319.32,102.7,13163,13291,-128,-0.96306
44,大分県,44214,国東市,26246,12509,13737,28647,-2401,-8.38133,91.06064,318.1,82.5,11899,12112,-213,-1.75859
44,大分県,44322,姫島村,1726,805,921,1991,-265,-13.30989,87.40499,6.99,246.9,832,879,-47,-5.34699
44,大分県,44341,日出町,27747,13236,14511,28058,-311,-1.10842,91.21356,73.32,378.4,11105,10855,250,2.30309
44,大分県,44461,九重町,8548,4038,4510,9645,-1097,-11.37377,89.53437,271.37,31.5,3314,3473,-159,-4.57817
44,大分県,44462,玖珠町,14399,6947,7452,15823,-1424,-8.99956,93.2233,286.6,50.2,5870,5988,-118,-1.97061
45,宮崎県,45201,宮崎市,401591,189373,212218,401138,453,0.11293,89.23513,643.67,623.9,184023,175408,8615,4.91141
45,宮崎県,45202,都城市,160736,75327,85409,165029,-4293,-2.60136,88.19562,653.36,246,71077,69965,1112,1.58937
45,宮崎県,45203,延岡市,118450,56099,62351,125159,-6709,-5.36038,89.9729,868.02,136.5,51597,51751,-154,-0.29758
45,宮崎県,45204,日南市,50891,23938,26953,54090,-3199,-5.91422,88.81386,536.11,94.9,22041,22678,-637,-2.80889
45,宮崎県,45205,小林市,43718,20338,23380,46221,-2503,-5.41529,86.98888,562.95,77.7,19168,19498,-330,-1.69248
45,宮崎県,45206,日向市,59647,28376,31271,61761,-2114,-3.42287,90.74222,336.95,177,25096,24815,281,1.13238
45,宮崎県,45207,串間市,16828,7877,8951,18779,-1951,-10.38926,88.00134,295.17,57,7218,7952,-734,-9.23038
45,宮崎県,45208,西都市,28643,13431,15212,30683,-2040,-6.64863,88.29214,438.79,65.3,11786,12004,-218,-1.81606
45,宮崎県,45209,えびの市,17645,8340,9305,19538,-1893,-9.68881,89.62923,282.93,62.4,8010,8568,-558,-6.51261
45,宮崎県,45341,三股町,25595,11929,13666,25404,191,0.75185,87.28962,110.02,232.6,10132,9967,165,1.65546
45,宮崎県,45361,高原町,8646,4126,4520,9300,-654,-7.03226,91.28319,85.39,101.3,3755,3914,-159,-4.06234
45,宮崎県,45382,国富町,18410,8610,9800,19606,-1196,-6.10017,87.85714,130.63,140.9,7470,7606,-136,-1.78806
45,宮崎県,45383,綾町,6938,3266,3672,7345,-407,-5.54118,88.94336,95.19,72.9,2864,2915,-51,-1.74957
45,宮崎県,45401,高鍋町,19928,9499,10429,21025,-1097,-5.2176,91.08256,43.8,455,8682,8678,4,0.04609
45,宮崎県,45402,新富町,16571,8098,8473,17373,-802,-4.61636,95.57418,61.53,269.3,6431,6376,55,0.86261
45,宮崎県,45403,西米良村,1000,492,508,1089,-89,-8.17264,96.85039,271.51,3.7,531,509,22,4.3222
45,宮崎県,45404,木城町,4898,2250,2648,5231,-333,-6.3659,84.96979,145.96,33.6,1886,1958,-72,-3.67722
45,宮崎県,45405,川南町,15196,7147,8049,16109,-913,-5.66764,88.79364,90.12,168.6,6030,5936,94,1.58356
45,宮崎県,45406,都農町,9913,4678,5235,10391,-478,-4.60013,89.36008,102.11,97.1,3959,3940,19,0.48223
45,宮崎県,45421,門川町,17387,8278,9109,18183,-796,-4.37772,90.87715,120.4,144.4,6870,6824,46,0.67409
45,宮崎県,45429,諸塚村,1486,725,761,1739,-253,-14.54859,95.26938,187.56,7.9,628,688,-60,-8.72093
45,宮崎県,45430,椎葉村,2506,1270,1236,2808,-302,-10.75499,102.75081,537.29,4.7,1057,1128,-71,-6.29433
45,宮崎県,45431,美郷町,4828,2338,2490,5480,-652,-11.89781,93.89558,448.84,10.8,2137,2332,-195,-8.36192
45,宮崎県,45441,高千穂町,11649,5605,6044,12755,-1106,-8.67111,92.7366,237.54,49,4516,4678,-162,-3.46302
45,宮崎県,45442,日之影町,3637,1746,1891,3946,-309,-7.83071,92.3321,277.67,13.1,1492,1493,-1,-0.06698
45,宮崎県,45443,五ヶ瀬町,3476,1697,1779,3887,-411,-10.57371,95.39067,171.73,20.2,1234,1277,-43,-3.36727
46,鹿児島県,46201,鹿児島市,593460,276188,317272,599814,-6354,-1.05933,87.05086,547.58,1083.8,279077,270269,8808,3.25898
46,鹿児島県,46203,鹿屋市,101204,48430,52774,103608,-2404,-2.32028,91.76867,448.15,225.8,45778,44911,867,1.93048
46,鹿児島県,46204,枕崎市,20052,9175,10877,22046,-1994,-9.04472,84.3523,74.78,268.1,9428,10062,-634,-6.30093
46,鹿児島県,46206,阿久根市,19289,9068,10221,21198,-1909,-9.00557,88.7193,134.28,143.6,8614,9196,-582,-6.32884
46,鹿児島県,46208,出水市,52016,24235,27781,53758,-1742,-3.24045,87.23588,329.98,157.6,22823,22508,315,1.3995
46,鹿児島県,46210,指宿市,39045,18109,20936,41831,-2786,-6.66013,86.49694,148.84,262.3,17773,18509,-736,-3.97644
46,鹿児島県,46213,西之表市,14701,7033,7668,15967,-1266,-7.92885,91.71883,205.66,71.5,7041,7368,-327,-4.43811
46,鹿児島県,46214,垂水市,13817,6395,7422,15520,-1703,-10.97294,86.16276,162.12,85.2,6560,6988,-428,-6.12479
46,鹿児島県,46215,薩摩川内市,92459,44574,47885,96076,-3617,-3.76473,93.08552,682.92,135.4,40989,40686,303,0.74473
46,鹿児島県,46216,日置市,47166,22161,25005,49249,-2083,-4.22953,88.62627,253.01,186.4,19417,19649,-232,-1.18072
46,鹿児島県,46217,曽於市,33312,15555,17757,36557,-3245,-8.87655,87.59926,390.14,85.4,15341,16134,-793,-4.91509
46,鹿児島県,46218,霧島市,123205,58986,64219,125857,-2652,-2.10715,91.85132,603.16,204.3,55463,54334,1129,2.07789
46,鹿児島県,46219,いちき串木野市,27511,12745,14766,29282,-1771,-6.04808,86.31315,112.29,245,11973,12159,-186,-1.52973
46,鹿児島県,46220,南さつま市,32894,15111,17783,35439,-2545,-7.18135,84.97441,283.59,116,14448,15361,-913,-5.94362
46,鹿児島県,46221,志布志市,29343,14005,15338,31479,-2136,-6.78548,91.30917,290.28,101.1,13235,13869,-634,-4.57135
46,鹿児島県,46222,奄美市,41416,19774,21642,43156,-1740,-4.03188,91.36864,308.33,134.3,19613,19627,-14,-0.07133
46,鹿児島県,46223,南九州市,33118,15451,17667,36352,-3234,-8.89635,87.45684,357.91,92.5,14411,15349,-938,-6.11115
46,鹿児島県,46224,伊佐市,24461,11314,13147,26810,-2349,-8.76166,86.05766,392.56,62.3,11397,12110,-713,-5.8877
46,鹿児島県,46225,姶良市,76405,35765,40640,75173,1232,1.63889,88.00443,231.25,330.4,32908,31435,1473,4.68586
46,鹿児島県,46303,三島村,405,191,214,407,-2,-0.4914,89.25234,31.39,12.9,218,223,-5,-2.24215
46,鹿児島県,46304,十島村,740,412,328,756,-16,-2.1164,125.60976,101.14,7.3,426,427,-1,-0.23419
46,鹿児島県,46392,さつま町,20272,9439,10833,22400,-2128,-9.5,87.13191,303.9,66.7,9234,9690,-456,-4.70588
46,鹿児島県,46404,長島町,9719,4711,5008,10431,-712,-6.82581,94.06949,116.19,83.6,3977,4137,-160,-3.86754
46,鹿児島県,46452,湧水町,9130,4405,4725,10327,-1197,-11.59098,93.22751,144.29,63.3,4103,4323,-220,-5.08906
46,鹿児島県,46468,大崎町,12385,5864,6521,13241,-856,-6.46477,89.92486,100.67,123,5907,6074,-167,-2.74942
46,鹿児島県,46482,東串良町,6236,2938,3298,6530,-294,-4.5023,89.08429,27.78,224.5,2773,2826,-53,-1.87544
46,鹿児島県,46490,錦江町,6944,3254,3690,7923,-979,-12.35643,88.18428,163.19,42.6,3172,3442,-270,-7.84428
46,鹿児島県,46491,南大隅町,6482,3080,3402,7542,-1060,-14.05463,90.53498,213.57,30.4,3153,3559,-406,-11.4077
46,鹿児島県,46492,肝付町,14237,6981,7256,15664,-1427,-9.11006,96.21003,308.1,46.2,6427,6974,-547,-7.84342
46,鹿児島県,46501,中種子町,7538,3553,3985,8135,-597,-7.33866,89.15935,137.18,54.9,3597,3741,-144,-3.84924
46,鹿児島県,46502,南種子町,5445,2726,2719,5745,-300,-5.22193,100.25745,110.36,49.3,2673,2727,-54,-1.9802
46,鹿児島県,46505,屋久島町,11869,5805,6064,12913,-1044,-8.08488,95.72889,540.48,22,5840,6133,-293,-4.77743
46,鹿児島県,46523,大和村,1366,674,692,1530,-164,-10.71895,97.39884,88.26,15.5,688,709,-21,-2.96192
46,鹿児島県,46524,宇検村,1621,791,830,1722,-101,-5.86527,95.3012,103.07,15.7,810,866,-56,-6.46651
46,鹿児島県,46525,瀬戸内町,8558,4209,4349,9042,-484,-5.3528,96.78087,239.65,35.7,4263,4413,-150,-3.39905
46,鹿児島県,46527,龍郷町,5820,2812,3008,5806,14,0.24113,93.48404,81.82,71.1,2563,2414,149,6.17233
46,鹿児島県,46529,喜界町,6628,3257,3371,7212,-584,-8.09762,96.61821,56.82,116.6,3306,3363,-57,-1.69492
46,鹿児島県,46530,徳之島町,10161,4968,5193,11160,-999,-8.95161,95.66724,104.92,96.8,4712,4960,-248,-5
46,鹿児島県,46531,天城町,5524,2784,2740,5975,-451,-7.54812,101.60584,80.4,68.7,2524,2623,-99,-3.7743
46,鹿児島県,46532,伊仙町,6139,3073,3066,6362,-223,-3.50519,100.22831,62.71,97.9,2781,2885,-104,-3.60485
46,鹿児島県,46533,和泊町,6246,3080,3166,6783,-537,-7.91685,97.28364,40.39,154.6,2881,2909,-28,-0.96253
46,鹿児島県,46534,知名町,5748,2860,2888,6213,-465,-7.48431,99.03047,53.3,107.8,2658,2692,-34,-1.263
46,鹿児島県,46535,与論町,5119,2460,2659,5186,-67,-1.29194,92.51598,20.58,248.7,2160,2056,104,5.05837
47,沖縄県,47201,那覇市,317832,154081,163751,319435,-1603,-0.50182,94.09469,41.42,7673.4,144041,135532,8509,6.27822
47,沖縄県,47205,宜野湾市,100192,48837,51355,96243,3949,4.10316,95.09687,19.8,5060.2,44064,39333,4731,12.02807
47,沖縄県,47207,石垣市,47675,23997,23678,47564,111,0.23337,101.34724,229.15,208.1,21969,20514,1455,7.09272
47,沖縄県,47208,浦添市,115741,55979,59762,114232,1509,1.321,93.66989,19.5,5935.4,46885,44041,2844,6.45762
47,沖縄県,47209,名護市,63564,31612,31952,61674,1890,3.0645,98.9359,210.94,301.3,28381,26142,2239,8.56476
47,沖縄県,47210,糸満市,61025,30701,30324,58547,2478,4.2325,101.24324,46.63,1308.7,23029,20647,2382,11.53679
47,沖縄県,47211,沖縄市,142840,69490,73350,139279,3561,2.55674,94.73756,49.72,2872.9,60451,53325,7126,13.36334
47,沖縄県,47212,豊見城市,64640,31475,33165,61119,3521,5.76089,94.90427,19.31,3347.5,24515,21780,2735,12.55739
47,沖縄県,47213,うるま市,125406,63059,62347,118898,6508,5.4736,101.142,87.02,1441.1,47959,42378,5581,13.16957
47,沖縄県,47214,宮古島市,52962,26486,26476,51186,1776,3.4697,100.03777,204.27,259.3,24156,21977,2179,9.91491
47,沖縄県,47215,南城市,44071,22170,21901,42016,2055,4.89099,101.22825,49.94,882.5,15884,14295,1589,11.11577
47,沖縄県,47301,国頭村,4521,2316,2205,4908,-387,-7.88509,105.03401,194.8,23.2,1976,2061,-85,-4.12421
47,沖縄県,47302,大宜味村,3104,1640,1464,3060,44,1.43791,112.02186,63.55,48.8,1306,1262,44,3.48653
47,沖縄県,47303,東村,1599,883,716,1720,-121,-7.03488,123.32402,81.88,19.5,723,748,-25,-3.34225
47,沖縄県,47306,今帰仁村,8904,4468,4436,9531,-627,-6.57853,100.72137,39.93,223,3550,3490,60,1.7192
47,沖縄県,47308,本部町,12543,6339,6204,13536,-993,-7.33599,102.17602,54.36,230.7,5385,5237,148,2.82605
47,沖縄県,47311,恩納村,10885,5509,5376,10652,233,2.18738,102.47396,50.84,214.1,4723,4065,658,16.18696
47,沖縄県,47313,宜野座村,5837,2907,2930,5597,240,4.28801,99.21502,31.3,186.5,2236,2003,233,11.63255
47,沖縄県,47314,金武町,10828,5372,5456,11232,-404,-3.59687,98.46041,37.84,286.2,4664,4611,53,1.14943
47,沖縄県,47315,伊江村,4123,2074,2049,4260,-137,-3.21596,101.22011,22.78,181,1896,1917,-21,-1.09546
47,沖縄県,47324,読谷村,41240,20243,20997,39504,1736,4.39449,96.40901,35.28,1168.9,15664,13658,2006,14.68736
47,沖縄県,47325,嘉手納町,13531,6563,6968,13685,-154,-1.12532,94.18772,15.12,894.9,5219,5069,150,2.95916
47,沖縄県,47326,北谷町,28223,13484,14739,28308,-85,-0.30027,91.48518,13.93,2026.1,11653,10724,929,8.66281
47,沖縄県,47327,北中城村,17984,8666,9318,16148,1836,11.36983,93.00279,11.54,1558.4,6548,5541,1007,18.17361
47,沖縄県,47328,中城村,22173,11039,11134,19454,2719,13.97656,99.14676,15.53,1427.8,8819,7209,1610,22.33319
47,沖縄県,47329,西原町,34996,17643,17353,34508,488,1.41416,101.67118,15.9,2201,13493,12641,852,6.73997
47,沖縄県,47348,与那原町,19705,9560,10145,18410,1295,7.03422,94.23361,5.18,3804.1,7952,7003,949,13.55134
47,沖縄県,47350,南風原町,40458,19833,20625,37502,2956,7.88225,96.16,10.76,3760,14634,12763,1871,14.65956
47,沖縄県,47353,渡嘉敷村,717,387,330,730,-13,-1.78082,117.27273,19.23,37.3,389,417,-28,-6.71463
47,沖縄県,47354,座間味村,892,485,407,870,22,2.52874,119.16462,16.74,53.3,501,453,48,10.59603
47,沖縄県,47355,粟国村,681,382,299,759,-78,-10.27668,127.7592,7.65,89,378,429,-51,-11.88811
47,沖縄県,47356,渡名喜村,348,207,141,430,-82,-19.06977,146.80851,3.87,89.9,220,267,-47,-17.603
47,沖縄県,47357,南大東村,1289,746,543,1329,-40,-3.00978,137.3849,30.52,42.2,680,686,-6,-0.87464
47,沖縄県,47358,北大東村,590,365,225,629,-39,-6.20032,162.22222,13.07,45.1,326,333,-7,-2.1021
47,沖縄県,47359,伊平屋村,1128,607,521,1238,-110,-8.8853,116.50672,21.82,51.7,518,516,2,0.3876
47,沖縄県,47360,伊是名村,1324,718,606,1517,-193,-12.72248,118.48185,15.43,85.8,637,695,-58,-8.34532
47,沖縄県,47361,久米島町,7201,3833,3368,7755,-554,-7.14378,113.80641,63.65,113.1,3329,3365,-36,-1.06984
47,沖縄県,47362,八重瀬町,30958,15245,15713,29066,1892,6.50932,97.02157,26.96,1148.3,10679,9625,1054,10.95065
47,沖縄県,47375,多良間村,1058,575,483,1194,-136,-11.39028,119.04762,22,48.1,465,470,-5,-1.06383
47,沖縄県,47381,竹富町,3946,2033,1913,3998,-52,-1.30065,106.27287,334.4,11.8,2093,2122,-29,-1.36664
47,沖縄県,47382,与那国町,1676,923,753,1843,-167,-9.06131,122.57636,28.9,58,759,1080,-321,-29.72222
